Year,imdb,Title,clean_test,binary,budget,domgross,intgross,totalgross
2013,tt1711425,21 & Over,notalk,FAIL,13000000,25682380,42195766,67878146
2012,tt1343727,Dredd 3D,ok,PASS,45000000,13414714,40868994,54283708
2013,tt2024544,12 Years a Slave,notalk,FAIL,20000000,53107035,158607035,211714070
2013,tt1272878,2 Guns,notalk,FAIL,61000000,75612460,132493015,208105475
2013,tt0453562,42,men,FAIL,40000000,95020213,95020213,190040426
2013,tt1335975,47 Ronin,men,FAIL,225000000,38362475,145803842,184166317
2013,tt1606378,A Good Day to Die Hard,notalk,FAIL,92000000,67349198,304249198,371598396
2013,tt2194499,About Time,ok,PASS,12000000,15323921,87324746,102648667
2013,tt1814621,Admission,ok,PASS,13000000,18007317,18007317,36014634
2013,tt1815862,After Earth,notalk,FAIL,130000000,60522097,244373198,304895295
2013,tt1800241,American Hustle,ok,PASS,40000000,148430908,249484909,397915817
2013,tt1322269,August: Osage County,ok,PASS,25000000,37304874,50304874,87609748
2013,tt1559547,Beautiful Creatures,ok,PASS,50000000,19452138,55940671,75392809
2013,tt2334873,Blue Jasmine,ok,PASS,18000000,33345833,68447831,101793664
2013,tt1535109,Captain Phillips,notalk,FAIL,55000000,107136417,218743570,325879987
2013,tt1939659,Carrie,ok,PASS,30000000,35266619,85001659,120268278
2013,tt1985966,Cloudy with a Chance of Meatballs 2,nowomen,FAIL,78000000,119640264,271725448,391365712
2013,tt1690953,Despicable Me 2,ok,PASS,76000000,368065385,970766005,1338831390
2013,tt2229499,Don Jon,dubious,FAIL,5500000,24477704,26377704,50855408
2013,tt1535108,Elysium,ok,PASS,120000000,93050117,286192091,379242208
2013,tt1731141,Ender Game,men,FAIL,110000000,61737191,89737191,151474382
2013,tt0848537,Epic,ok,PASS,100000000,107518682,268418682,375937364
2013,tt0765446,Escape from Planet Earth,ok,PASS,40000000,57012977,66454811,123467788
2013,tt1211956,Escape Plan,men,FAIL,70000000,25213103,103813103,129026206
2013,tt1288558,Evil Dead,ok,PASS,17000000,54239856,97402049,151641905
2013,tt1905041,Fast and Furious 6,ok,PASS,160000000,238679850,788128122,1026807972
2013,tt2294629,Frozen,ok,PASS,150000000,393050114,1004550114,1397600228
2013,tt1583421,G.I. Joe: Retaliation,ok,PASS,140000000,122523060,371923060,494446120
2013,tt1321870,Gangster Squad,notalk,FAIL,60000000,46000903,104100903,150101806
2013,tt2425486,Gloria,ok,PASS,30000000,4167493,4967493,9134986
2013,tt1454468,Gravity,nowomen,FAIL,110000000,271814796,708714796,980529592
2013,tt2191701,Grown Ups 2,men,FAIL,80000000,133668525,247023808,380692333
2013,tt1428538,Hansel &amp; Gretel: Witch Hunters,ok,PASS,50000000,55703475,225703475,281406950
2013,tt1798709,Her,men,FAIL,23000000,25000178,33029713,58029891
2013,tt2024432,Identity Thief,men,FAIL,35000000,134506920,176269721,310776641
2013,tt2226417,Insidious: Chapter 2,men,FAIL,5000000,83586447,161911222,245497669
2013,tt1300854,Iron Man 3,dubious,FAIL,200000000,408992272,1212692272,1621684544
2013,tt1351685,Jack the Giant Slayer,nowomen,FAIL,195000000,65187603,197387603,262575206
2013,tt1650554,Kick-Ass 2,ok,PASS,28000000,28795985,60839197,89635182
2013,tt1204975,Last Vegas,notalk,FAIL,28000000,63914167,112914167,176828334
2013,tt1327773,Lee Daniels&#39; The Butler,ok,PASS,30000000,116632095,151513429,268145524
2013,tt2002718,Machete Kills,ok,PASS,2000000,8008161,9408161,17416322
2013,tt2023587,Mama,ok,PASS,15000000,71628180,148041253,219669433
2013,tt0770828,Man of Steel,ok,PASS,225000000,291045518,687999518,979045036
2013,tt1821549,Nebraska,ok,PASS,12000000,17482517,17482517,34965034
2013,tt1670345,Now You See Me,notalk,FAIL,75000000,117723989,351723989,469447978
2013,tt1483013,Oblivion,men,FAIL,120000000,89107235,287537983,376645218
2013,tt2302755,Olympus Has Fallen,notalk,FAIL,70000000,98927592,150562164,249489756
2013,tt1623205,Oz the Great and Powerful,ok,PASS,200000000,234770996,489570996,724341992
2013,tt1663662,Pacific Rim,notalk,FAIL,190000000,101802906,411002906,512805812
2013,tt1980209,Pain & Gain,notalk,FAIL,26000000,49875291,81275291,131150582
2013,tt1904996,Parker,ok,PASS,35000000,17616641,46346651,63963292
2013,tt1699755,Peeples,dubious,FAIL,15000000,9177065,9177065,18354130
2013,tt1854564,Percy Jackson: Sea of Monsters,ok,PASS,90000000,68559554,200859554,269419108
2013,tt1392214,Prisoners,ok,PASS,46000000,61002302,113402302,174404604
2013,tt0790736,R.I.P.D.,notalk,FAIL,130000000,33618855,79019947,112638802
2013,tt1821694,Red 2,ok,PASS,84000000,53262560,137162560,190425120
2013,tt1411250,Riddick,notalk,FAIL,38000000,42025135,92425135,134450270
2013,tt2364841,Runner Runner,nowomen,FAIL,30000000,19316646,62616646,81933292
2013,tt1979320,Rush,notalk,FAIL,38000000,26947624,43047624,69995248
2013,tt1702439,Safe Haven,ok,PASS,28000000,71399120,93943623,165342743
2013,tt2140373,Saving Mr. Banks,ok,PASS,35000000,82834332,100734332,183568664
2013,tt2053463,Side Effects,ok,PASS,30000000,32172757,60288363,92461120
2013,tt1408101,Star Trek Into Darkness,notalk,FAIL,190000000,228778661,466978661,695757322
2013,tt1572315,Texas Chainsaw 3D,ok,PASS,20000000,34341945,39093317,73435262
2013,tt1931435,The Big Wedding,ok,PASS,32500000,21819348,35770721,57590069
2013,tt0816442,The Book Thief,ok,PASS,19000000,21345525,62045525,83391050
2013,tt1911644,The Call,ok,PASS,13000000,51872378,58938768,110811146
2013,tt1457767,The Conjuring,ok,PASS,20000000,137400141,318000141,455400282
2013,tt2193215,The Counselor,ok,PASS,25000000,16973715,70373715,87347430
2013,tt0481499,The Croods,men,FAIL,135000000,187168425,573068425,760236850
2013,tt2404311,The Family,men,FAIL,30000000,36918811,51078541,87997352
2013,tt1837703,The Fifth Estate,notalk,FAIL,26000000,3254172,6154172,9408344
2013,tt1343092,The Great Gatsby,dubious,FAIL,190000000,144840419,351040419,495880838
2013,tt1951261,The Hangover part 3,men,FAIL,103000000,112200072,362000072,474200144
2013,tt2404463,The Heat,ok,PASS,43000000,159581587,230781587,390363174
2013,tt1170358,The Hobbit: The Desolation of Smaug,notalk,FAIL,250000000,257397516,937397516,1194795032
2013,tt1517260,The Host,dubious,FAIL,50000000,26623701,58188384,84812085
2013,tt1951264,The Hunger Games: Catching Fire,ok,PASS,130000000,424088260,857088260,1281176520
2013,tt0790628,The Incredible Burt Wonderstone,notalk,FAIL,32000000,22537881,24255957,46793838
2013,tt2234155,The Internship,notalk,FAIL,58000000,44672764,93672764,138345528
2013,tt2034139,The Last Exorcism Part II,ok,PASS,4000000,15179303,18541236,33720539
2013,tt1210819,The Lone Ranger,notalk,FAIL,275000000,89289910,259989910,349279820
2013,tt1538403,The Mortal Instruments: City of Bones,ok,PASS,60000000,31165421,75965567,107130988
2013,tt2184339,The Purge,dubious,FAIL,3000000,64473115,91100541,155573656
2013,tt2017020,The Smurfs 2,ok,PASS,110000000,71017784,348545841,419563625
2013,tt1758795,The To Do List,ok,PASS,1500000,3491669,3491669,6983338
2013,tt1727388,The Way Way Back,ok,PASS,5000000,21502690,26161443,47664133
2013,tt0993846,The Wolf of Wall Street,notalk,FAIL,100000000,115702857,365702857,481405714
2013,tt1430132,The Wolverine,ok,PASS,115000000,132556852,416456852,549013704
2013,tt1213663,The World&#39;s End,men,FAIL,20000000,26004851,46578821,72583672
2013,tt1245492,This Is the End,notalk,FAIL,32000000,101470202,126294264,227764466
2013,tt1981115,Thor: The Dark World,dubious,FAIL,170000000,204674790,631674790,836349580
2013,tt1924429,Trance,nowomen,FAIL,16000000,2322593,22594052,24916645
2013,tt1860353,Turbo,dubious,FAIL,135000000,83028130,283828130,366856260
2013,tt1588173,Warm Bodies,men,FAIL,30000000,66380662,116643610,183024272
2013,tt1723121,We're the Millers,ok,PASS,37000000,150394119,270000119,420394238
2013,tt2334879,White House Down,men,FAIL,150000000,73103784,205440387,278544171
2013,tt0816711,World War Z,dubious,FAIL,190000000,202359711,539559711,741919422
2012,tt1611224,Abraham Lincoln: Vampire Hunter,dubious,FAIL,67500000,37519139,115119139,152638278
2012,tt1591479,Act of Valor,nowomen,FAIL,12000000,70012847,82497035,152509882
2012,tt1602620,Amour,dubious,FAIL,9700000,6738954,25915719,32654673
2012,tt1781769,Anna Karenina,men,FAIL,49000000,12816367,70735540,83551907
2012,tt1024648,Argo,ok,PASS,44500000,136025503,221300694,357326197
2012,tt1440129,Battleship,notalk,FAIL,209000000,65235400,304142720,369378120
2012,tt2125435,Beasts of the Southern Wild,dubious,FAIL,1800000,12795746,21080058,33875804
2012,tt1758575,Blue Like Jazz,ok,PASS,1200000,595018,595018,1190036
2012,tt1217209,Brave,ok,PASS,185000000,237282182,554606532,791888714
2012,tt1308729,Bullet to the Head,nowomen,FAIL,55000000,9489829,13561515,23051344
2012,tt1991245,Chernobyl Diaries,notalk,FAIL,1000000,18119640,38390020,56509660
2012,tt1706593,Chronicle,notalk,FAIL,12000000,64575175,127075175,191650350
2012,tt1371111,Cloud Atlas,ok,PASS,102000000,27108272,126018564,153126836
2012,tt1524137,Contraband,ok,PASS,25000000,66528000,98406855,164934855
2012,tt1853728,Django Unchained,notalk,FAIL,100000000,162805434,425373688,588179122
2012,tt1907668,Flight,dubious,FAIL,31000000,93772375,161772375,255544750
2012,tt1142977,Frankenweenie,nowomen,FAIL,39000000,35287788,81150788,116438576
2012,tt2243973,Hannibal,ok,PASS,87000000,165092266,350100280,515192546
2012,tt0837562,Hotel Transylvania,ok,PASS,85000000,148313048,359222014,507535062
2012,tt0790724,Jack Reacher,notalk,FAIL,60000000,80070736,217370736,297441472
2012,tt2106476,Jagten,men,FAIL,3450000,687185,687185,1374370
2012,tt0401729,John Carter,ok,PASS,275000000,73058679,282778100,355836779
2012,tt1764234,Killing Them Softly,nowomen,FAIL,15000000,14945541,37238774,52184315
2012,tt1707386,Les Miserables,ok,PASS,65000000,148809770,442022894,590832664
2012,tt0454876,Life of Pi,notalk,FAIL,120000000,124987022,607987022,732974044
2012,tt0443272,Lincoln,ok,PASS,65000000,182207973,273000960,455208933
2012,tt1277953,Madagascar 3: Europe&#39;s Most Wanted,men,FAIL,145000000,216391482,746921271,963312753
2012,tt1409024,Men in Black III,notalk,FAIL,215000000,179020854,624821154,803842008
2012,tt1667353,Mirror Mirror,dubious,FAIL,85000000,64935167,168611991,233547158
2012,tt1748122,Moonrise Kingdom,ok,PASS,16000000,45512466,64012466,109524932
2012,tt2094064,Much Ado About Nothing,dubious,FAIL,8000000,22549338,22549338,45098676
2012,tt1598828,One for the Money,ok,PASS,42000000,26414527,36197221,62611748
2012,tt2109184,Paranormal Activity 4,ok,PASS,5000000,53900335,142793842,196694177
2012,tt1623288,ParaNorman,notalk,FAIL,60000000,56003051,108159011,164162062
2012,tt1047540,Parental Guidance,ok,PASS,25000000,77267296,120168633,197435929
2012,tt1716777,People Like Us,ok,PASS,16000000,12431792,12431792,24863584
2012,tt1981677,Pitch Perfect,ok,PASS,17000000,65001093,115331177,180332270
2012,tt1547234,Premium Rush,ok,PASS,35000000,20275446,31393201,51668647
2012,tt1234719,Red Dawn,notalk,FAIL,65000000,44806783,48164150,92970933
2012,tt0485985,Red Tails,men,FAIL,58000000,49876377,50365498,100241875
2012,tt1446192,Rise of the Guardians,notalk,FAIL,145000000,103412758,306900902,410313660
2012,tt1336608,Rock of Ages,ok,PASS,70000000,38518613,50118613,88637226
2012,tt1656190,Safe,notalk,FAIL,33000000,17142080,41495213,58637293
2012,tt1862079,Safety Not Guaranteed,ok,PASS,750000,4010957,4413188,8424145
2012,tt1931533,Seven Psychopaths,notalk,FAIL,13500000,15024049,23492318,38516367
2012,tt0938330,Silent Hill: Revelation 3D,ok,PASS,20000000,17530219,47944599,65474818
2012,tt1045658,Silver Linings Playbook,ok,PASS,21000000,132092958,227317397,359410355
2012,tt1922777,Sinister,men,FAIL,3000000,48086903,87727807,135814710
2012,tt1074638,Skyfall,dubious,FAIL,200000000,304360277,1108694081,1413054358
2012,tt1735898,Snow White and the Huntsman,ok,PASS,170000000,155136755,400911200,556047955
2012,tt1876451,Sparkle,ok,PASS,10000000,24397469,24660323,49057792
2012,tt2101441,Spring Breakers,ok,PASS,5000000,14124286,30669531,44793817
2012,tt1800741,Step Up Revolution,ok,PASS,33000000,35074677,165552290,200626967
2012,tt1874789,Supporting Characters,men,FAIL,60000,4917,4917,9834
2012,tt1637725,Ted,men,FAIL,50000000,218665740,549444574,768110314
2012,tt1232200,That's My Boy,notalk,FAIL,67500000,36931089,58058367,94989456
2012,tt0948470,The Amazing Spider-Man,men,FAIL,220000000,262030663,757890267,1019920930
2012,tt0848228,The Avengers,notalk,FAIL,60000000,23385416,48585416,71970832
2012,tt1345836,The Dark Knight Rises,notalk,FAIL,275000000,448139099,1079343943,1527483042
2012,tt1560985,The Devil Inside,ok,PASS,1000000,53261944,101758489,155020433
2012,tt1645170,The Dictator,notalk,FAIL,65000000,59650222,179379532,239029754
2012,tt1764651,The Expendables 2,ok,PASS,100000000,85028192,311979256,397007448
2012,tt1601913,The Grey,nowomen,FAIL,25000000,51580136,84339696,135919832
2012,tt0903624,The Hobbit: An Unexpected Journey,nowomen,FAIL,250000000,303003568,1014703568,1317707136
2012,tt1392170,The Hunger Games,ok,PASS,80000000,408010692,684510692,1092521384
2012,tt1649419,The Impossible,men,FAIL,40000000,19019882,169590606,188610488
2012,tt1258972,The Man with the Iron Fists,notalk,FAIL,15000000,15634090,21985095,37619185
2012,tt1560747,The Master,notalk,FAIL,37500000,16247159,25116740,41363899
2012,tt1430626,The Pirates! Band of Misfits,notalk,FAIL,55000000,31051126,123056220,154107346
2012,tt1817273,The Place Beyond the Pines,notalk,FAIL,15000000,21403519,47011449,68414968
2012,tt1673434,The Twilight Saga: Breaking Dawn - Part 2,dubious,FAIL,136200000,292324737,832660037,1124984774
2012,tt1606389,The Vow,ok,PASS,8738320,125014030,197618160,322632190
2012,tt1298649,The Watch,men,FAIL,55000000,34353000,67353000,101706000
2012,tt1596365,The Woman in Black,notalk,FAIL,15000000,54333290,128955898,183289188
2012,tt1840417,The Words,notalk,FAIL,6000000,11494838,12132578,23627416
2012,tt1621045,Think Like a Man,ok,PASS,12000000,91547205,96155124,187702329
2012,tt1859650,To Rome With Love,men,FAIL,21500000,16684352,74363777,91048129
2012,tt1386703,Total Recall,notalk,FAIL,125000000,58877969,198615996,257493965
2012,tt1496025,Underworld: Awakening,ok,PASS,70000000,62321039,160379930,222700969
2012,tt1655460,Wanderlust,ok,PASS,32500000,17288155,24159934,41448089
2012,tt1586265,What to Expect When You&#39;re Expecting,ok,PASS,37500000,41152203,80652203,121804406
2012,tt1870529,Won&#39;t Back Down,ok,PASS,19000000,5310554,5431486,10742040
2012,tt1646987,Wrath of the Titans,notalk,FAIL,150000000,83670083,301970083,385640166
2012,tt1772341,Wreck-It Ralph,ok,PASS,165000000,189412677,473412677,662825354
2012,tt1790885,Zero Dark Thirty,ok,PASS,52500000,95720716,137720716,233441432
2011,tt1622547,30 Minutes or Less,notalk,FAIL,28000000,37053924,40966716,78020640
2011,tt1306980,50/50,men,FAIL,8000000,35016118,41334735,76350853
2011,tt1571222,A Dangerous Method,dubious,FAIL,20000000,5702083,14807531,20509614
2011,tt1422136,A Lonely Place to Die,ok,PASS,4000000,N/A,442550,#VALUE!
2011,tt1268799,A Very Harold &amp; Kumar 3D Christmas,notalk,FAIL,20000000,35061031,36265745,71326776
2011,tt1549572,Another Earth,ok,PASS,175000,1321194,1781194,3102388
2011,tt1772240,Apollo 18,nowomen,FAIL,5000000,17686929,26517819,44204748
2011,tt1430607,Arthur Christmas,notalk,FAIL,85000000,46462469,147624649,194087118
2011,tt1478964,Attack the Block,ok,PASS,13000000,1024175,5406422,6430597
2011,tt1284575,Bad Teacher,ok,PASS,19000000,100292856,216412265,316705121
2011,tt1217613,Battle: Los Angeles,notalk,FAIL,70000000,83552429,212005201,295557630
2011,tt1152398,Beastly,notalk,FAIL,17000000,27865571,38028230,65893801
2011,tt1629705,Blackthorn,notalk,FAIL,4500000,200558,1249765,1450323
2011,tt1478338,Bridesmaids,ok,PASS,32500000,169106725,289263136,458369861
2011,tt0458339,Captain America: The First Avenger,notalk,FAIL,140000000,176654505,370569776,547224281
2011,tt1216475,Cars 2,men,FAIL,200000000,191450875,560155383,751606258
2011,tt1684628,Circumstance,ok,PASS,900000,454121,454121,908242
2011,tt1657507,Colombiana,notalk,FAIL,40000000,36665854,71698079,108363933
2011,tt0816462,Conan the Barbarian,dubious,FAIL,20000000,38264085,79114085,117378170
2011,tt1598778,Contagion,ok,PASS,60000000,75658097,137551594,213209691
2011,tt1372686,Coriolanus,men,FAIL,10000000,749641,1049641,1799282
2011,tt0409847,Cowboys &amp; Aliens,notalk,FAIL,163000000,100240551,175910315,276150866
2011,tt1701990,Detention,ok,PASS,10000000,N/A,N/A,#VALUE!
2011,tt1650043,Diary of a Wimpy Kid: Rodrick Rules,notalk,FAIL,18000000,52698535,73695194,126393729
2011,tt1564349,Dolphin Tale,men,FAIL,37000000,72286779,96068724,168355503
2011,tt1462041,Dream House,ok,PASS,50000000,21302340,39932340,61234680
2011,tt0780504,Drive,dubious,FAIL,15000000,35060689,78054825,113115514
2011,tt1596343,Fast Five,ok,PASS,125000000,209837675,629841284,839678959
2011,tt1622979,Final Destination 5,men,FAIL,40000000,42587643,157887643,200475286
2011,tt1068242,Footloose,ok,PASS,24000000,51802742,63412773,115215515
2011,tt1438176,Fright Night,dubious,FAIL,30000000,18298649,40520649,58819298
2011,tt1133985,Green Lantern,notalk,FAIL,200000000,116601172,231201172,347802344
2011,tt0480687,Hall Pass,men,FAIL,36000000,45060734,83693266,128754000
2011,tt0993842,Hanna,ok,PASS,30000000,40259119,65343694,105602813
2011,tt1201607,Harry Potter and the Deathly Hallows: Part 2,notalk,FAIL,125000000,381011219,1328111219,1709122438
2011,tt1506999,Haywire,nowomen,FAIL,23000000,18942396,22176190,41118586
2011,tt1403177,Hesher,notalk,FAIL,7000000,382946,382946,765892
2011,tt1562568,Higher Ground,ok,PASS,1800000,841056,859182,1700238
2011,tt1640459,Hobo with a Shotgun,nowomen,FAIL,3000000,703372,834953,1538325
2011,tt1411704,Hop,men,FAIL,63000000,108085305,184924333,293009638
2011,tt1499658,Horrible Bosses,ok,PASS,35000000,117538559,214538559,332077118
2011,tt0970179,Hugo,dubious,FAIL,180000000,73864507,185033215,258897722
2011,tt1464540,I Am Number Four,notalk,FAIL,50000000,55100437,145982797,201083234
2011,tt1253864,Immortals,men,FAIL,75000000,83504017,211562435,295066452
2011,tt1637688,In Time,notalk,FAIL,35000000,37553932,170064664,207618596
2011,tt1606618,Iris,ok,PASS,5500000,5580479,15155021,20735500
2011,tt1410063,Jin ling shi san chai,ok,PASS,100000000,311434,93721434,94032868
2011,tt1634122,Johnny English Reborn,dubious,FAIL,45000000,8305970,164539660,172845630
2011,tt1640484,Jumping the Broom,ok,PASS,7000000,37295394,38158601,75453995
2011,tt1564367,Just Go with It,dubious,FAIL,80000000,103028109,214974953,318003062
2011,tt1788391,Kill List,dubious,FAIL,800000,29063,462206,491269
2011,tt1448755,Killer Elite,nowomen,FAIL,70000000,25124986,57777106,82902092
2011,tt1302011,Kung Fu Panda 2,ok,PASS,150000000,165249063,664837547,830086610
2011,tt1508675,Le Havre,dubious,FAIL,5500000,611709,13480196,14091905
2011,tt1758692,Like Crazy,ok,PASS,250000,3395391,3731489,7126880
2011,tt1219289,Limitless,notalk,FAIL,27000000,79249455,169739455,248988910
2011,tt0466893,Margaret,ok,PASS,14000000,47185,47185,94370
2011,tt1615147,Margin Call,notalk,FAIL,3400000,5353586,17872206,23225792
2011,tt1305591,Mars Needs Moms,dubious,FAIL,150000000,21392758,39549758,60942516
2011,tt1441326,Martha Marcy May Marlene,ok,PASS,1000000,2981038,3531038,6512076
2011,tt1527186,Melancholia,ok,PASS,9400000,3030848,18044073,21074921
2011,tt1605783,Midnight in Paris,ok,PASS,30000000,56816662,154816662,211633324
2011,tt1229238,Mission: Impossible - Ghost Protocol,notalk,FAIL,145000000,209397903,694713230,904111133
2011,tt1210166,Moneyball,notalk,FAIL,50000000,75605492,111174374,186779866
2011,tt1396218,Mr. Popper&#39;s Penguins,notalk,FAIL,55000000,68224452,189624452,257848904
2011,tt1598822,New Year&#39;s Eve,ok,PASS,26000000,54544638,143663899,198208537
2011,tt1411238,No Strings Attached,ok,PASS,25000000,70662220,149228078,219890298
2011,tt1720182,October Baby,ok,PASS,1000000,5355847,5355847,10711694
2011,tt1637706,Our Idiot Brother,ok,PASS,5000000,24814830,25861249,50676079
2011,tt1778304,Paranormal Activity 3,ok,PASS,5000000,104028807,207039844,311068651
2011,tt1092026,Paul,ok,PASS,40000000,37412945,100179814,137592759
2011,tt1298650,Pirates of the Caribbean: On Stranger Tides,notalk,FAIL,250000000,241063875,1043663875,1284727750
2011,tt0822847,Priest,notalk,FAIL,60000000,29136626,84154026,113290652
2011,tt0448694,Puss in Boots,notalk,FAIL,130000000,149260504,554987477,704247981
2011,tt1192628,Rango,notalk,FAIL,135000000,123257581,245504574,368762155
2011,tt0433035,Real Steel,notalk,FAIL,110000000,85463309,293237309,378700618
2011,tt1486185,Red Riding Hood,ok,PASS,42000000,37662162,90300442,127962604
2011,tt0873886,Red State,ok,PASS,4000000,1065429,1065429,2130858
2011,tt1498569,Restless,ok,PASS,8000000,163753,2818394,2982147
2011,tt1436562,Rio,notalk,FAIL,90000000,143619809,487519809,631139618
2011,tt1318514,Rise of the Planet of the Apes,notalk,FAIL,93000000,176760185,482860185,659620370
2011,tt1723811,Shame,notalk,FAIL,6500000,4002293,10781688,14783981
2011,tt1541995,Snow Flower and the Secret Fan,ok,PASS,6000000,1348205,11348205,12696410
2011,tt1596346,Soul Surfer,ok,PASS,18000000,43853424,47158652,91012076
2011,tt0945513,Source Code,notalk,FAIL,32000000,54712227,140428499,195140726
2011,tt0999913,Straw Dogs,ok,PASS,25000000,10324441,11253821,21578262
2011,tt0978764,Sucker Punch,ok,PASS,75000000,36392502,89758389,126150891
2011,tt1650062,Super 8,ok,PASS,50000000,127004179,260095987,387100166
2011,tt1675192,Take Shelter,ok,PASS,4750000,1728953,3128953,4857906
2011,tt1385826,The Adjustment Bureau,dubious,FAIL,50200000,62495645,127793502,190289147
2011,tt0983193,The Adventures of Tintin,notalk,FAIL,130000000,77591831,373993951,451585782
2011,tt1655442,The Artist,notalk,FAIL,16000000,44667095,128256712,172923807
2011,tt1412386,The Best Exotic Marigold Hotel,ok,PASS,10000000,46383639,134729347,181112986
2011,tt1259521,The Cabin in the Woods,dubious,FAIL,30000000,42073277,70768144,112841421
2011,tt1093357,The Darkest Hour,ok,PASS,34800000,21443494,62831715,84275209
2011,tt1535616,The Divide,ok,PASS,3000000,18000,18000,36000
2011,tt1235170,The Future,ok,PASS,1000000,568662,568662,1137324
2011,tt1568346,The Girl with the Dragon Tattoo,notalk,FAIL,90000000,102515793,233170238,335686031
2011,tt0990407,The Green Hornet,notalk,FAIL,110000000,98780042,227983150,326763192
2011,tt1540133,The Guard,notalk,FAIL,6000000,5359774,15944629,21304403
2011,tt1454029,The Help,ok,PASS,25000000,169705587,213120004,382825591
2011,tt1007029,The Iron Lady,ok,PASS,14000000,29959436,115592104,145551540
2011,tt1189340,The Lincoln Lawyer,notalk,FAIL,40000000,58009200,87145086,145154286
2011,tt0472399,The Mechanic,nowomen,FAIL,42500000,29121498,76347393,105468891
2011,tt1204342,The Muppets,notalk,FAIL,45000000,88625922,160971922,249597844
2011,tt1161864,The Rite,dubious,FAIL,37000000,33047633,96047633,129095266
2011,tt1265990,The Roommate,ok,PASS,16000000,37300107,40497461,77797568
2011,tt0472181,The Smurfs,ok,PASS,110000000,142614158,563066551,705680709
2011,tt1509767,The Three Musketeers,men,FAIL,90000000,20377913,139877913,160255826
2011,tt0478304,The Tree of Life,nowomen,FAIL,35000000,13305665,62305665,75611330
2011,tt1324999,The Twilight Saga: Breaking Dawn - Part 1,ok,PASS,127500000,281287133,709938657,991225790
2011,tt0800369,Thor,ok,PASS,150000000,181030624,449326618,630357242
2011,tt1340800,Tinker Tailor Soldier Spy,notalk,FAIL,21000000,24149393,81452811,105602204
2011,tt0471042,Tower Heist,notalk,FAIL,85000000,78046570,153470352,231516922
2011,tt1399103,Transformers: Dark of the Moon,ok,PASS,195000000,352390543,1123794076,1476184619
2011,tt1568911,War Horse,notalk,FAIL,70000000,79883359,156815529,236698888
2011,tt1291584,Warrior,notalk,FAIL,25000000,13657115,24215385,37872500
2011,tt1389137,We Bought a Zoo,men,FAIL,50000000,75624550,118924550,194549100
2011,tt1714210,Weekend,notalk,FAIL,190000,484592,1577585,2062177
2011,tt0770703,What&#39;s Your Number,ok,PASS,20000000,14011084,30711084,44722168
2011,tt1449283,Winnie the Pooh,nowomen,FAIL,30000000,26692846,50145607,76838453
2011,tt1270798,X-Men: First Class,ok,PASS,160000000,146408305,355408305,501816610
2011,tt1625346,Young Adult,ok,PASS,12000000,16311571,22750356,39061927
2011,tt1742336,Your Sister&#39;s Sister,ok,PASS,120000,1597486,3090593,4688079
2010,tt1542344,127 Hours,dubious,FAIL,18000000,18335230,60735230,79070460
2010,tt1014759,Alice in Wonderland,ok,PASS,200000000,334191110,1024391110,1358582220
2010,tt1313092,Animal Kingdom,notalk,FAIL,4200000,1044039,8078683,9122722
2010,tt1431181,Another Year,ok,PASS,8000000,3205706,18505706,21711412
2010,tt1423894,Barney&#39;s Version,ok,PASS,30000000,7502560,8845575,16348135
2010,tt1532503,Beginners,notalk,FAIL,3200000,5790894,11564267,17355161
2010,tt1164999,Biutiful,notalk,FAIL,35000000,5101237,25101237,30202474
2010,tt0947798,Black Swan,ok,PASS,13000000,106954678,331266710,438221388
2010,tt1120985,Blue Valentine,men,FAIL,1000000,9737892,16566240,26304132
2010,tt1126591,Burlesque,ok,PASS,55000000,39440655,89657398,129098053
2010,tt1194417,Casino Jack,notalk,FAIL,12500000,2039869,2080869,4120738
2010,tt1020558,Centurion,notalk,FAIL,15000000,123570,6623570,6747140
2010,tt1438254,Charlie St. Cloud,notalk,FAIL,44000000,31206263,48478084,79684347
2010,tt0800320,Clash of the Titans,dubious,FAIL,125000000,163214888,493214888,656429776
2010,tt1244754,Conviction,ok,PASS,12500000,6797696,10133552,16931248
2010,tt1385867,Cop Out,notalk,FAIL,37000000,44875481,55909910,100785391
2010,tt1555064,Country Strong,ok,PASS,15000000,20218921,20551476,40770397
2010,tt1336617,Cyrus,notalk,FAIL,7000000,7468936,10039886,17508822
2010,tt1279935,Date Night,ok,PASS,55000000,98711404,152269033,250980437
2010,tt0989757,Dear John,nowomen,FAIL,25000000,80014842,111362410,191377252
2010,tt1323594,Despicable Me,ok,PASS,69000000,251513985,543495033,795009018
2010,tt1314655,Devil,ok,PASS,10000000,33679655,63354114,97033769
2010,tt1196141,Diary of a Wimpy Kid,ok,PASS,15000000,64003625,76954311,140957936
2010,tt0427152,Dinner for Schmucks,notalk,FAIL,69000000,73026337,86796502,159822839
2010,tt1270761,Don&#39;t Be Afraid of the Dark,ok,PASS,25000000,24046682,31551048,55597730
2010,tt1231583,Due Date,notalk,FAIL,65000000,100539043,211739043,312278086
2010,tt1013860,Dylan Dog: Dead of Night,nowomen,FAIL,20000000,1186538,6090697,7277235
2010,tt1282140,Easy A,ok,PASS,8000000,58401464,76200721,134602185
2010,tt0879870,"Eat, Pray, Love",ok,PASS,60000000,80574010,205846861,286420871
2010,tt1226273,Edge of Darkness,notalk,FAIL,60000000,43313890,81208697,124522587
2010,tt1531663,Everything Must Go,notalk,FAIL,5000000,2712131,2712131,5424262
2010,tt0977855,Fair Game,ok,PASS,50000000,11497497,26097497,37594994
2010,tt1433108,Faster,nowomen,FAIL,12000000,23240020,35658648,58898668
2010,tt1405500,For Colored Girls,ok,PASS,21000000,37729698,38017873,75747571
2010,tt1323045,Frozen,notalk,FAIL,150000000,393050114,1004550114,1397600228
2010,tt1226229,Get Him To The Greek,notalk,FAIL,40000000,61153526,91455875,152609401
2010,tt1322312,Going the Distance,ok,PASS,32000000,17804299,39990165,57794464
2010,tt0947810,Green Zone,nowomen,FAIL,100000000,35497337,97523020,133020357
2010,tt1375670,Grown Ups,ok,PASS,75000000,162001186,272223430,434224616
2010,tt1376195,Gunless,men,FAIL,9900000,458054,458054,916108
2010,tt0926084,Harry Potter and the Deathly Hallows: Part 1,ok,PASS,125000000,295983305,956399711,1252383016
2010,tt1231587,Hot Tub Time Machine,notalk,FAIL,36000000,50269859,63209958,113479817
2010,tt0892769,How to Train Your Dragon,ok,PASS,165000000,217581231,494870991,712452222
2010,tt1226236,I Am Love,ok,PASS,10000000,5005465,15132211,20137676
2010,tt1375666,Inception,dubious,FAIL,160000000,292576195,832584416,1125160611
2010,tt1591095,Insidious,ok,PASS,1500000,54009150,99870886,153880036
2010,tt1228705,Iron Man 2,ok,PASS,170000000,312433331,623561331,935994662
2010,tt0804497,It&#39;s Kind of a Funny Story,notalk,FAIL,8000000,6363628,6628326,12991954
2010,tt1250777,Kick-Ass,notalk,FAIL,28000000,48071303,97527535,145598838
2010,tt1013743,Knight and Day,men,FAIL,117000000,76423035,262142047,338565082
2010,tt1038686,Legion,ok,PASS,26000000,40168080,68854097,109022177
2010,tt1228987,Let Me In,notalk,FAIL,20000000,12134935,28270399,40405334
2010,tt0892318,Letters to Juliet,dubious,FAIL,30000000,53032453,79135982,132168435
2010,tt0758752,Love and Other Drugs,men,FAIL,30000000,32367005,102719647,135086652
2010,tt0985694,Machete,ok,PASS,12500000,26593646,44331957,70925603
2010,tt1371155,Made In Dagenham,ok,PASS,8000000,1095369,15644196,16739565
2010,tt1518812,Meek&#39;s Cutoff,men,FAIL,2000000,977772,1869928,2847700
2010,tt1001526,Megamind,nowomen,FAIL,130000000,148415853,321887208,470303061
2010,tt1470827,Monsters,nowomen,FAIL,500000,237301,5639730,5877031
2010,tt1126618,Morning Glory,ok,PASS,40000000,31011732,60040974,91052706
2010,tt1415283,Nanny McPhee and the Big Bang,ok,PASS,35000000,29197642,97799865,126997507
2010,tt1334260,Never Let Me Go,ok,PASS,15000000,2434652,11509512,13944164
2010,tt1536044,Paranormal Activity 2,ok,PASS,3000000,84752907,177512032,262264939
2010,tt0814255,Percy Jackson &amp; the Olympians: The Lightning Thief,dubious,FAIL,95000000,88768303,226467130,315235433
2010,tt0878835,Please Give,ok,PASS,3000000,4033574,4570178,8603752
2010,tt1424381,Predators,nowomen,FAIL,40000000,52000688,127234389,179235077
2010,tt0473075,Prince of Persia: The Sands of Time,nowomen,FAIL,200000000,90759676,335059676,425819352
2010,tt0935075,Rabbit Hole,ok,PASS,5000000,2229058,5839592,8068650
2010,tt0493949,Ramona and Beezus,ok,PASS,15000000,26167002,27469621,53636623
2010,tt1245526,Red,men,FAIL,60000000,90380162,196439693,286819855
2010,tt1403981,Remember Me,ok,PASS,16000000,19068240,56506120,75574360
2010,tt1053424,Repo Men,ok,PASS,32000000,13942007,18195238,32137245
2010,tt0955308,Robin Hood,dubious,FAIL,210000000,105487148,322459006,427946154
2010,tt0944835,Salt,ok,PASS,130000000,118311368,295713467,414024835
2010,tt0446029,Scott Pilgrim vs. the World,ok,PASS,85000000,31611316,48089760,79701076
2010,tt1028576,Secretariat,ok,PASS,35000000,59699513,60376247,120075760
2010,tt1261945,Sex and the city 2,ok,PASS,95000000,95347692,294680778,390028470
2010,tt0892791,Shrek Forever After,notalk,FAIL,165000000,238736787,756244673,994981460
2010,tt1130884,Shutter Island,notalk,FAIL,80000000,128012934,296831073,424844007
2010,tt1564585,Skyline,dubious,FAIL,10000000,21416355,78693371,100109726
2010,tt1421051,Somewhere,dubious,FAIL,7000000,1785645,14385645,16171290
2010,tt1440292,Submarine,notalk,FAIL,1900000,467602,4581937,5049539
2010,tt1512235,Super,notalk,FAIL,2500000,327716,518362,846078
2010,tt1135084,Takers,notalk,FAIL,32000000,57744720,70587268,128331988
2010,tt0398286,Tangled,ok,PASS,260000000,200821936,586581936,787403872
2010,tt0429493,The A-Team,nowomen,FAIL,110000000,77222099,177241171,254463270
2010,tt1212436,The Back-up Plan,ok,PASS,35000000,37490007,75281179,112771186
2010,tt0980970,The Chronicles of Narnia: The Voyage of the Dawn Treader,ok,PASS,155000000,104386950,418186950,522573900
2010,tt0968264,The Conspirator,dubious,FAIL,25000000,11538204,15907411,27445615
2010,tt0455407,The Crazies,ok,PASS,19000000,39123589,54956140,94079729
2010,tt1226753,The Debt,ok,PASS,20000000,31177548,46604054,77781602
2010,tt1320253,The Expendables,notalk,FAIL,82000000,103068524,268268174,371336698
2010,tt0964517,The Fighter,men,FAIL,11000000,93617009,129262388,222879397
2010,tt1139328,The Ghost Writer,men,FAIL,45000000,15541549,65532491,81074040
2010,tt0775489,The Illusionist,nowomen,FAIL,16500000,39868642,83792062,123660704
2010,tt1155076,The Karate Kid,dubious,FAIL,40000000,176591618,359091618,535683236
2010,tt0842926,The Kids Are All Right,ok,PASS,4000000,20811365,36275469,57086834
2010,tt0954947,The Killer Inside Me,notalk,FAIL,13000000,217277,3617277,3834554
2010,tt1504320,The King&#39;s Speech,ok,PASS,15000000,138797449,430821166,569618615
2010,tt0938283,The Last Airbender,notalk,FAIL,150000000,131772187,319713881,451486068
2010,tt1320244,The Last Exorcism,ok,PASS,1800000,41034350,70165900,111200250
2010,tt0480255,The Losers,notalk,FAIL,25000000,23591432,26714018,50305450
2010,tt1458175,The Next Three Days,ok,PASS,30000000,21148651,67255916,88404567
2010,tt1386588,The Other Guys,nowomen,FAIL,100000000,119219978,170936470,290156448
2010,tt1017451,The Runaways,ok,PASS,9500000,3573673,5278632,8852305
2010,tt1285016,The Social Network,notalk,FAIL,40000000,96962694,224922135,321884829
2010,tt0963966,The Sorcerer&#39;s Apprentice,notalk,FAIL,160000000,63150991,215150991,278301982
2010,tt1273678,The Spy Next Door,ok,PASS,28000000,24307106,50983364,75290470
2010,tt0889573,The Switch,men,FAIL,19000000,27758465,49858465,77616930
2010,tt1274300,The Tempest,ok,PASS,20000000,277943,277943,555886
2010,tt1243957,The Tourist,nowomen,FAIL,100000000,67631157,278731369,346362526
2010,tt0840361,The Town,notalk,FAIL,37000000,92186262,152566881,244753143
2010,tt1325004,The Twilight Saga: Eclipse,ok,PASS,68000000,300531751,699590681,1000122432
2010,tt0780653,The Wolfman,notalk,FAIL,150000000,62189884,142634358,204824242
2010,tt1570989,Tiny Furniture,ok,PASS,50000,391674,424149,815823
2010,tt0435761,Toy Story 3,dubious,FAIL,200000000,415004880,1063759456,1478764336
2010,tt1104001,Tron Legacy,notalk,FAIL,200000000,172062763,397562763,569625526
2010,tt1403865,True Grit,ok,PASS,35000000,171243005,252276928,423519933
2010,tt1465522,Tucker and Dale vs Evil,ok,PASS,5000000,223838,5476793,5700631
2010,tt0477080,Unstoppable,dubious,FAIL,95000000,81562942,169511609,251074551
2010,tt0817230,Valentine&#39;s Day,ok,PASS,52000000,110485654,217569328,328054982
2010,tt1027718,Wall Street: Money Never Sleeps,dubious,FAIL,70000000,52474616,137431619,189906235
2010,tt1183923,Welcome to the Rileys,ok,PASS,10000000,152857,312857,465714
2010,tt1235189,Wild Target,notalk,FAIL,8000000,109338,109338,218676
2010,tt1399683,Winter&#39;s Bone,ok,PASS,2000000,6531503,16131552,22663055
2010,tt1216520,Womb,ok,PASS,13000000,N/A,N/A,#VALUE!
2010,tt1302067,Yogi Bear,nowomen,FAIL,80000000,100246011,202284317,302530328
2010,tt1414382,You Again,ok,PASS,20000000,25702053,32838945,58540998
2010,tt1182350,You Will Meet a Tall Dark Stranger,ok,PASS,15000000,3247816,34247816,37495632
2009,tt1022603,(500) Days of Summer,notalk,FAIL,7500000,32391374,60803210,93194584
2009,tt0974661,17 Again,ok,PASS,40000000,64167069,139474906,203641975
2009,tt1190080,2012,notalk,FAIL,200000000,166112167,788408539,954520706
2009,tt0472033,9,nowomen,FAIL,30000000,31749894,48559999,80309893
2009,tt0971209,A Perfect Getaway,dubious,FAIL,14000000,15515460,22815460,38330920
2009,tt1019452,A Serious Man,men,FAIL,7000000,9228788,30360570,39589358
2009,tt1315981,A Single Man,notalk,FAIL,7000000,9176000,28142379,37318379
2009,tt1185836,Adam,men,FAIL,3200000,2277396,2828590,5105986
2009,tt1091722,Adventureland,men,FAIL,9800000,16044025,17144025,33188050
2009,tt1186830,Agora,notalk,FAIL,70000000,619423,38992292,39611715
2009,tt1077262,Ajami,men,FAIL,1000000,621859,621859,1243718
2009,tt0881891,All About Steve,ok,PASS,15000000,33862903,40127259,73990162
2009,tt1174732,An Education,ok,PASS,7500000,12574914,29652736,42227650
2009,tt0808151,Angels &amp; Demons,nowomen,FAIL,150000000,133375846,490875846,624251692
2009,tt0913354,Armored,nowomen,FAIL,20000000,15988876,23661038,39649914
2009,tt0375568,Astro Boy,dubious,FAIL,65000000,19551067,44093014,63644081
2009,tt0499549,Avatar,men,FAIL,425000000,760507625,2783918982,3544426607
2009,tt1176740,Away We Go,ok,PASS,21000000,9451946,10108016,19559962
2009,tt0889583,Br&uuml;no,nowomen,FAIL,42000000,60054530,130788243,190842773
2009,tt0901476,Bride Wars,ok,PASS,30000000,58715510,115150424,173865934
2009,tt0810784,Bright Star,ok,PASS,8500000,4444637,17260680,21705317
2009,tt1210042,Brooklyn&#39;s Finest,notalk,FAIL,17000000,27163593,39233233,66396826
2009,tt0765010,Brothers,ok,PASS,26000000,28544157,45043870,73588027
2009,tt1232207,Capitalism: A Love Story,notalk,FAIL,20000000,14363397,19121531,33484928
2009,tt0795351,Case 39,ok,PASS,27000000,13261851,29302804,42564655
2009,tt1352824,Chloe,men,FAIL,13000000,3075255,9675172,12750427
2009,tt0844471,Cloudy with a Chance of Meatballs,notalk,FAIL,100000000,124870275,236827677,361697952
2009,tt1035736,Coco avant Chanel,ok,PASS,23000000,6113834,50813834,56927668
2009,tt0327597,Coraline,ok,PASS,60000000,75286229,126037057,201323286
2009,tt0433362,Daybreakers,notalk,FAIL,20000000,30101577,51401577,81503154
2009,tt1278340,Dead Snow,men,FAIL,800000,46742,2194020,2240762
2009,tt1136608,District 9,notalk,FAIL,30000000,115646235,215196627,330842862
2009,tt1127180,Drag Me to Hell,ok,PASS,30000000,42100625,91388487,133489112
2009,tt1191111,Enter the Void,notalk,FAIL,16000000,337997,337997,675994
2009,tt0780511,Everybody&#39;s Fine,men,FAIL,20000000,9208876,9208876,18417752
2009,tt0432283,Fantastic Mr. Fox,notalk,FAIL,40000000,21002919,46498922,67501841
2009,tt1013752,Fast &amp; Furious,notalk,FAIL,85000000,155064265,363064265,518128530
2009,tt1083456,Fired Up!,notalk,FAIL,20000000,17231291,18608570,35839861
2009,tt1232776,Fish Tank,ok,PASS,3000000,374675,5922292,6296967
2009,tt0758746,Friday the 13th,men,FAIL,17000000,65002019,91700771,156702790
2009,tt1201167,Funny People,notalk,FAIL,72500000,51855045,71880305,123735350
2009,tt0436339,G-Force,notalk,FAIL,150000000,119436770,287389685,406826455
2009,tt1046173,G.I. Joe: The Rise of Cobra,notalk,FAIL,175000000,150201498,302469017,452670515
2009,tt1034032,Gamer,notalk,FAIL,50000000,20534907,35062683,55597590
2009,tt1194263,Get Low,notalk,FAIL,7000000,9176933,9696933,18873866
2009,tt1289406,Harry Brown,notalk,FAIL,7300000,1818681,6294140,8112821
2009,tt0417741,Harry Potter and the Half-Blood Prince,ok,PASS,250000000,301959197,934416487,1236375684
2009,tt1001508,He&#39;s Just Not That Into You,ok,PASS,40000000,93953653,178390243,272343896
2009,tt1024744,I Come with the Rain,nowomen,FAIL,18000000,0,627422,627422
2009,tt1045772,I Love You Phillip Morris,notalk,FAIL,13000000,2037459,15144685,17182144
2009,tt1155056,"I Love You, Man",men,FAIL,40000000,71440011,91729503,163169514
2009,tt1080016,Ice Age: Dawn of the Dinosaurs,notalk,FAIL,90000000,196573705,886968695,1083542400
2009,tt0361748,Inglourious Basterds,dubious,FAIL,70000000,120831050,316971720,437802770
2009,tt1057500,Invictus,notalk,FAIL,49000000,37491364,124491364,161982728
2009,tt1230414,It&#39;s Complicated,ok,PASS,85000000,112735375,224614744,337350119
2009,tt1131734,Jennifer&#39;s Body,ok,PASS,16000000,16204793,32832166,49036959
2009,tt1135503,Julie &amp; Julia,ok,PASS,40000000,94125426,126646119,220771545
2009,tt0448011,Knowing,notalk,FAIL,50000000,79957634,187858642,267816276
2009,tt1197624,Law Abiding Citizen,notalk,FAIL,53000000,73357727,131159781,204517508
2009,tt0808526,Life During Wartime,ok,PASS,4500000,281447,281447,562894
2009,tt1149361,Micmacs (Micmacs &agrave; tire-larigot),dubious,FAIL,42000000,1259693,11756922,13016615
2009,tt0892782,Monsters vs Aliens,dubious,FAIL,175000000,198351526,381687380,580038906
2009,tt1182345,Moon,notalk,FAIL,5000000,5010163,10676073,15686236
2009,tt1121977,Mother and Child,ok,PASS,7000000,1110509,5010509,6121018
2009,tt1179891,My Bloody Valentine 3D,men,FAIL,14000000,51545952,102754998,154300950
2009,tt1078588,My Sister&#39;s Keeper,ok,PASS,27500000,49200230,96673002,145873232
2009,tt0875034,Nine,men,FAIL,80000000,19676965,53508858,73185823
2009,tt1186367,Ninja Assassin,notalk,FAIL,50000000,38122883,61622883,99745766
2009,tt1266029,Nowhere Boy,dubious,FAIL,1900000,1445366,7785229,9230595
2009,tt1235796,Ondine,ok,PASS,12000000,550472,550472,1100944
2009,tt1532957,Paa,men,FAIL,4300000,199228,9791282,9990510
2009,tt1188729,Pandorum,notalk,FAIL,40000000,10330853,17033431,27364284
2009,tt1003034,Perrier&#39;s Bounty,nowomen,FAIL,6600000,828,828,1656
2009,tt0762125,Planet 51,notalk,FAIL,60000000,42194060,108996113,151190173
2009,tt0929632,Precious: Based on the Novel Push by Sapphire,ok,PASS,10000000,47566524,68722848,116289372
2009,tt1152836,Public Enemies,notalk,FAIL,102500000,97104620,210379983,307484603
2009,tt0465580,Push,ok,PASS,38000000,31811527,44411527,76223054
2009,tt0988045,Sherlock Holmes,notalk,FAIL,90000000,209028679,498438212,707466891
2009,tt1017460,Splice,ok,PASS,30000000,17010170,22461001,39471171
2009,tt0796366,Star Trek,ok,PASS,140000000,257730019,385680446,643410465
2009,tt0473705,State of Play,ok,PASS,60000000,37017955,91445389,128463344
2009,tt0986263,Surrogates,notalk,FAIL,80000000,38577772,119668350,158246122
2009,tt0438488,Terminator Salvation,men,FAIL,200000000,125322469,371628539,496951008
2009,tt0878804,The Blind Side,men,FAIL,35000000,255959475,305705795,561665270
2009,tt1131729,The Boat That Rocked,nowomen,FAIL,50000000,8017467,37472651,45490118
2009,tt1300851,The Boondock Saints II: All Saints Day,nowomen,FAIL,8000000,10273187,10273187,20546374
2009,tt0362478,The Box,ok,PASS,25000000,15051977,26341896,41393873
2009,tt0896923,The City of Your Final Destination,ok,PASS,8300000,493296,1353296,1846592
2009,tt1144884,The Final Destination,ok,PASS,40000000,66477700,187384627,253862327
2009,tt1220198,The Fourth Kind,ok,PASS,10000000,26218170,49486874,75705044
2009,tt1132620,The Girl with the Dragon Tattoo,dubious,FAIL,90000000,102515793,233170238,335686031
2009,tt1103982,The Girlfriend Experience,dubious,FAIL,1300000,695840,1005840,1701680
2009,tt1247662,The Good Guy,ok,PASS,10000000,100688,100688,201376
2009,tt1119646,The Hangover,notalk,FAIL,35000000,277322503,469553471,746875974
2009,tt1054606,The Imaginarium of Doctor Parnassus,notalk,FAIL,30000000,7689607,64352607,72042214
2009,tt1130080,The Informant!,notalk,FAIL,22000000,33316821,41771168,75087989
2009,tt1058017,The Invention of Lying,men,FAIL,18500000,18451251,32679264,51130515
2009,tt0824758,The Last Station,ok,PASS,18000000,6617867,15696146,22314013
2009,tt0380510,The Lovely Bones,ok,PASS,95000000,44114232,94894448,139008680
2009,tt1234548,The Men Who Stare at Goats,nowomen,FAIL,24000000,32428195,67348218,99776413
2009,tt0790712,The Messenger,notalk,FAIL,6500000,1109660,1409660,2519320
2009,tt0780521,The Princess and the Frog,ok,PASS,105000000,104400899,270997378,375398277
2009,tt1041829,The Proposal,men,FAIL,40000000,163958031,314709717,478667748
2009,tt0898367,The Road,notalk,FAIL,25000000,8114270,27614270,35728540
2009,tt0485601,The Secret of Kells,nowomen,FAIL,8000000,690290,2600916,3291206
2009,tt0821642,The Soloist,notalk,FAIL,60000000,31720158,38454152,70174310
2009,tt1111422,The Taking of Pelham 123,nowomen,FAIL,110000000,65452312,152364370,217816682
2009,tt0452694,The Time Traveler&#39;s Wife,dubious,FAIL,39000000,63414846,98666635,162081481
2009,tt1142988,The Ugly Truth,men,FAIL,38000000,88915214,205230042,294145256
2009,tt1139668,The Unborn,ok,PASS,16000000,42670410,78208812,120879222
2009,tt0962736,The Young Victoria,ok,PASS,35000000,11001272,31878891,42880163
2009,tt1055369,Transformers: Revenge of the Fallen,ok,PASS,210000000,402111870,836519699,1238631569
2009,tt1049413,Up,notalk,FAIL,175000000,293004164,731542621,1024546785
2009,tt1193138,Up in the Air,men,FAIL,30000000,83823381,166842739,250666120
2009,tt1068678,Veronika Decides to Die,ok,PASS,9000000,N/A,N/A,#VALUE!
2009,tt0409459,Watchmen,men,FAIL,138000000,107509799,184068357,291578156
2009,tt1178663,Whatever Works,dubious,FAIL,15000000,5306706,35106706,40413412
2009,tt0386117,Where the Wild Things Are,notalk,FAIL,100000000,77233467,99123656,176357123
2009,tt1172233,Whip It,ok,PASS,15000000,13043363,18856151,31899514
2009,tt0365929,Whiteout,ok,PASS,35000000,10275638,12254746,22530384
2009,tt0458525,X-Men Origins: Wolverine,dubious,FAIL,150000000,179883157,374825760,554708917
2009,tt0448182,Yesterday Was a Lie,ok,PASS,200000,N/A,N/A,#VALUE!
2009,tt0403702,Youth in Revolt,notalk,FAIL,18000000,15285588,19685588,34971176
2009,tt1156398,Zombieland,ok,PASS,23600000,75590286,102236596,177826882
2008,tt0478087,21,ok,PASS,35000000,81159365,157852532,239011897
2008,tt0800308,Appaloosa,notalk,FAIL,20000000,20211394,27735474,47946868
2008,tt0455824,Australia,men,FAIL,130000000,49554002,215080810,264634812
2008,tt0871426,Baby Mama,ok,PASS,30000000,60494212,64391484,124885696
2008,tt0799934,Be Kind Rewind,notalk,FAIL,20000000,11175164,30894247,42069411
2008,tt0960731,Bedtime Stories,ok,PASS,80000000,110101975,218357961,328459936
2008,tt0861689,Blindness,ok,PASS,25000000,3073392,20052958,23126350
2008,tt0397892,Bolt,ok,PASS,150000000,114053759,313953759,428007518
2008,tt0887883,Burn After Reading,notalk,FAIL,37000000,60355347,163415735,223771082
2008,tt0824747,Changeling,ok,PASS,55000000,35739802,113805580,149545382
2008,tt0892255,Che: Part One,notalk,FAIL,58000000,293708,30118557,30412265
2008,tt0970411,City of Ember,ok,PASS,38000000,7871693,11817059,19688752
2008,tt1060277,Cloverfield,ok,PASS,25000000,80048433,170764033,250812466
2008,tt0489018,Day of the Dead,ok,PASS,18000000,N/A,N/A,#VALUE!
2008,tt0452608,Death Race,notalk,FAIL,65000000,36316032,72516819,108832851
2008,tt1034303,Defiance,ok,PASS,50000000,28644813,42268745,70913558
2008,tt0832266,"Definitely, Maybe",ok,PASS,7000000,32241649,55863786,88105435
2008,tt0483607,Doomsday,ok,PASS,33000000,11008770,21621188,32629958
2008,tt0918927,Doubt,ok,PASS,20000000,33446470,50946957,84393427
2008,tt1059786,Eagle Eye,notalk,FAIL,80000000,101440743,178066569,279507312
2008,tt0808244,Easy Virtue,ok,PASS,14000000,2656784,12656784,15313568
2008,tt1129423,Fireproof,men,FAIL,500000,33456317,33473297,66929614
2008,tt0486321,Fly Me to the Moon,nowomen,FAIL,25000000,14543943,57546746,72090689
2008,tt0800039,Forgetting Sarah Marshall,ok,PASS,30000000,63172463,105173042,168345505
2008,tt0369436,Four Christmases,ok,PASS,80000000,120146040,163546040,283692080
2008,tt0870111,Frost/Nixon,notalk,FAIL,29000000,18622031,28144586,46766617
2008,tt0978759,Frozen River,ok,PASS,1000000,2511476,6030129,8541605
2008,tt0876563,Gake no ue no Ponyo,ok,PASS,34000000,15090399,205312666,220403065
2008,tt0995039,Ghost Town,notalk,FAIL,20000000,13252641,26612350,39864991
2008,tt1205489,Gran Torino,men,FAIL,25000000,148095302,274543085,422638387
2008,tt1104733,Hamlet 2,ok,PASS,9000000,4886216,4898285,9784501
2008,tt0448157,Hancock,nowomen,FAIL,150000000,227946274,624346274,852292548
2008,tt1227929,Herb &amp; Dorothy,ok,PASS,82500000,75986503,160388063,236374566
2008,tt0962726,High School Musical 3: Senior Year,ok,PASS,11000000,90559416,274392880,364952296
2008,tt0465502,Igor,men,FAIL,30000000,19528602,31013349,50541951
2008,tt0780536,In Bruges,notalk,FAIL,15000000,7800825,34533783,42334608
2008,tt0367882,Indiana Jones and the Kingdom of the Crystal Skull,notalk,FAIL,185000000,317023851,786558145,1103581996
2008,tt0494238,Inkheart,ok,PASS,60000000,17303424,58051454,75354878
2008,tt0371746,Iron Man,men,FAIL,186000000,318604126,582443126,901047252
2008,tt0373051,Journey to the Center of the Earth,notalk,FAIL,45000000,101704370,240904370,342608740
2008,tt0489099,Jumper,notalk,FAIL,82500000,81168265,223113205,304281470
2008,tt0441773,Kung Fu Panda,notalk,FAIL,130000000,215434591,631910531,847345122
2008,tt1139797,L&aring;t den r&auml;tte komma in (Let the Right One In),notalk,FAIL,4500000,2122085,12247682,14369767
2008,tt0866439,Made of Honor,men,FAIL,40000000,46012734,106548738,152561472
2008,tt0467197,Max Payne,ok,PASS,35000000,40687294,85761789,126449083
2008,tt0765476,Meet Dave,notalk,FAIL,60000000,11803254,50648806,62452060
2008,tt1013753,Milk,notalk,FAIL,20000000,31841299,57293371,89134670
2008,tt1046997,Miracle at St. Anna,men,FAIL,45000000,7916887,9110458,17027345
2008,tt0981227,Nick and Norah&#39;s Infinite Playlist,ok,PASS,10000000,31487293,33544594,65031887
2008,tt0410377,Nim&#39;s Island,ok,PASS,37000000,48006762,94081683,142088445
2008,tt0910936,Pineapple Express,men,FAIL,26000000,87341380,101549277,188890657
2008,tt1226681,Pontypool,nowomen,FAIL,1500000,3865,31916,35781
2008,tt0368563,Possession,ok,PASS,25000000,10103647,14805812,24909459
2008,tt0926129,Prom Night,ok,PASS,18000000,43869350,57109687,100979037
2008,tt0830515,Quantum of Solace,notalk,FAIL,230000000,169368427,591692078,761060505
2008,tt1082868,Quarantine,ok,PASS,12000000,31691811,41291811,72983622
2008,tt1084950,Rachel Getting Married,ok,PASS,12000000,12796861,13326864,26123725
2008,tt0959337,Revolutionary Road,ok,PASS,45000000,22911480,79564960,102476440
2008,tt1032755,RocknRolla,notalk,FAIL,18000000,5700626,27794339,33494965
2008,tt0814314,Seven Pounds,ok,PASS,54000000,69951824,166617328,236569152
2008,tt1000774,Sex and the City,ok,PASS,57500000,152647258,415247258,567894516
2008,tt1010048,Slumdog Millionaire,notalk,FAIL,14000000,141319928,384519665,525839593
2008,tt0811080,Speed Racer,ok,PASS,120000000,43945766,93394462,137340228
2008,tt0942903,Stargate: The Ark of Truth,dubious,FAIL,7000000,N/A,N/A,#VALUE!
2008,tt0838283,Step Brothers,notalk,FAIL,65000000,100468793,128468793,228937586
2008,tt0862846,Sunshine Cleaning,ok,PASS,5000000,12062558,16462558,28525116
2008,tt0383028,"Synecdoche, New York",dubious,FAIL,20000000,3083538,4383538,7467076
2008,tt0936501,Taken,ok,PASS,25000000,145000989,226941585,371942574
2008,tt0200465,The Bank Job,ok,PASS,20000000,30060660,66143005,96203665
2008,tt0844286,The Brothers Bloom,dubious,FAIL,20000000,3531756,5531756,9063512
2008,tt0499448,The Chronicles of Narnia: Prince Caspian,ok,PASS,225000000,141621490,419490286,561111776
2008,tt0421715,The Curious Case of Benjamin Button,dubious,FAIL,160000000,127509326,329809326,457318652
2008,tt0468569,The Dark Knight,dubious,FAIL,185000000,533345358,1002891358,1536236716
2008,tt0970416,The Day the Earth Stood Still,ok,PASS,80000000,79366978,233066978,312433956
2008,tt0406759,The Eye,ok,PASS,12000000,31418697,56918697,88337394
2008,tt0865556,The Forbidden Kingdom,notalk,FAIL,55000000,52075270,129075270,181150540
2008,tt0852713,The House Bunny,ok,PASS,25000000,48237389,70237389,118474778
2008,tt0887912,The Hurt Locker,notalk,FAIL,15000000,17017811,49894223,66912034
2008,tt0800080,The Incredible Hulk,notalk,FAIL,137500000,134806913,263417913,398224826
2008,tt0981072,The Lucky Ones,ok,PASS,14000000,266967,266967,533934
2008,tt0467200,The Other Boleyn Girl,ok,PASS,40000000,26814957,77714957,104529914
2008,tt0976051,The Reader,notalk,FAIL,32500000,34194407,113019290,147213697
2008,tt0416212,The Secret Life of Bees,ok,PASS,11000000,37770162,39984023,77754185
2008,tt1018785,The Sisterhood of the Traveling Pants 2,ok,PASS,27000000,44089964,44270131,88360095
2008,tt0482606,The Strangers,dubious,FAIL,9000000,52597610,83051676,135649286
2008,tt420238,The Tale of Despereaux,ok,PASS,60000000,50877145,90482317,141359462
2008,tt0430770,The Women,ok,PASS,16000000,26902075,50103808,77005883
2008,tt1125849,The Wrestler,notalk,FAIL,6000000,26238243,46634275,72872518
2008,tt0882978,Three Kingdoms: Resurrection of the Dragon,notalk,FAIL,20000000,N/A,22139590,#VALUE!
2008,tt0800241,Transsiberian,ok,PASS,15000000,2203641,6379575,8583216
2008,tt0942385,Tropic Thunder,nowomen,FAIL,90000000,110461307,188163455,298624762
2008,tt1099212,Twilight,ok,PASS,37000000,192769854,397923934,590693788
2008,tt0985699,Valkyrie,notalk,FAIL,90000000,83077762,203902107,286979869
2008,tt0497465,Vicky Cristina Barcelona,ok,PASS,16000000,23216709,104504817,127721526
2008,tt0910970,WALL-E,notalk,FAIL,180000000,223808164,532590994,756399158
2008,tt1185616,Waltz with Bashir,nowomen,FAIL,2000000,2283849,11125664,13409513
2008,tt0493464,Wanted,notalk,FAIL,75000000,134508551,342416460,476925011
2008,tt0494652,"Welcome Home, Roscoe Jenkins",dubious,FAIL,27500000,42436517,43607627,86044144
2008,tt1152850,Wendy and Lucy,ok,PASS,300000,865695,1416046,2281741
2008,tt1033643,What Happens In Vegas,ok,PASS,35000000,80277646,218535708,298813354
2008,tt1068680,Yes Man,notalk,FAIL,50000000,97690976,225990976,323681952
2007,tt1038988,[Rec],ok,PASS,2100000,N/A,27117954,#VALUE!
2007,tt0450385,1408,ok,PASS,22500000,71985628,131263370,203248998
2007,tt0463854,28 Weeks Later,ok,PASS,15000000,28638916,64232714,92871630
2007,tt0381849,3:10 to Yuma,nowomen,FAIL,48000000,53606916,71171825,124778741
2007,tt0389722,30 Days of Night,men,FAIL,30000000,39568996,80276156,119845152
2007,tt0411061,88 Minutes,notalk,FAIL,30000000,16930884,32955399,49886283
2007,tt0445922,Across the Universe,ok,PASS,45000000,24343673,29367143,53710816
2007,tt0783233,Atonement,ok,PASS,30000000,50980159,130200290,181180449
2007,tt0416508,Becoming Jane,ok,PASS,16500000,18663911,39364948,58028859
2007,tt0442933,Beowulf,ok,PASS,150000000,82195215,194995215,277190430
2007,tt0445934,Blades of Glory,ok,PASS,61000000,118594548,145594548,264189096
2007,tt0398808,Bridge to Terabithia,ok,PASS,25000000,82234139,137984788,220218927
2007,tt0283503,Brooklyn Rules,ok,PASS,8000000,458232,458232,916464
2007,tt0423977,Charlie Bartlett,men,FAIL,12000000,3950294,5295909,9246203
2007,tt0472062,Charlie Wilson&#39;s War,ok,PASS,75000000,66661095,119512771,186173866
2007,tt0795368,Death at a Funeral,ok,PASS,21000000,42739347,48977233,91716580
2007,tt0848557,Diary of the Dead,ok,PASS,2750000,952620,5394447,6347067
2007,tt0486822,Disturbia,ok,PASS,20000000,80209692,117573043,197782735
2007,tt0765443,Eastern Promises,ok,PASS,50000000,17181265,55367342,72548607
2007,tt0461770,Enchanted,ok,PASS,85000000,127706877,340384141,468091018
2007,tt0486576,Fantastic Four: Rise of the Silver Surfer,dubious,FAIL,120000000,131921738,288215319,420137057
2007,tt0452623,Gone Baby Gone,ok,PASS,19000000,20300218,34619699,54919917
2007,tt0427327,Hairspray,ok,PASS,75000000,118871849,202871849,321743698
2007,tt0373883,Halloween,ok,PASS,15000000,58269151,77514401,135783552
2007,tt0367959,Hannibal Rising,notalk,FAIL,50000000,27669725,80583311,108253036
2007,tt0373889,Harry Potter and the Order of the Phoenix,ok,PASS,150000000,292004738,942943935,1234948673
2007,tt0465494,Hitman,nowomen,FAIL,17500000,39687694,99965792,139653486
2007,tt0498353,Hostel: Part II,ok,PASS,7500000,17544812,33606409,51151221
2007,tt0425112,Hot Fuzz,notalk,FAIL,16000000,23618786,81742618,105361404
2007,tt0787475,Hot Rod,notalk,FAIL,25000000,13938332,14334401,28272733
2007,tt0480249,I Am Legend,ok,PASS,150000000,256393010,585410052,841803062
2007,tt0758758,Into the Wild,notalk,FAIL,20000000,18354356,56395211,74749567
2007,tt0467406,Juno,ok,PASS,7000000,143495265,231450102,374945367
2007,tt0478311,Knocked Up,ok,PASS,27500000,148761765,219154490,367916255
2007,tt0805564,Lars and the real Girl,ok,PASS,12500000,5956480,10553442,16509922
2007,tt0337978,Live Free or Die Hard,notalk,FAIL,110000000,134529403,383531464,518060867
2007,tt0465538,Michael Clayton,men,FAIL,21500000,49033882,92987651,142021533
2007,tt0758766,Music and Lyrics,men,FAIL,40000000,50572589,145021477,195594066
2007,tt0477348,No Country for Old Men,dubious,FAIL,25000000,74273505,164051250,238324755
2007,tt0481141,No Reservations,ok,PASS,28000000,43107979,91665799,134773778
2007,tt1179904,Paranormal Activity,dubious,FAIL,450000,107918810,194183034,302101844
2007,tt0808417,Persepolis,ok,PASS,7300000,4443403,22742498,27185901
2007,tt0449088,Pirates of the Caribbean: At World&#39;s End,ok,PASS,300000000,309420425,960996492,1270416917
2007,tt0477071,Premonition,ok,PASS,20000000,47852604,81461343,129313947
2007,tt0382932,Ratatouille,nowomen,FAIL,150000000,206445654,626549695,832995349
2007,tt0432021,Resident Evil: Extinction,ok,PASS,45000000,50648679,146162920,196811599
2007,tt00293564,Rush Hour 3,notalk,FAIL,180000000,140125968,253025968,393151936
2007,tt0822854,Shooter,notalk,FAIL,60000000,47003582,95703582,142707164
2007,tt0413267,Shrek the Third,ok,PASS,160000000,322719944,807330936,1130050880
2007,tt0964587,St. Trinian&#39;s,ok,PASS,11400000,15000,22446568,22461568
2007,tt0486655,Stardust,ok,PASS,70000000,38634938,135556675,174191613
2007,tt0448134,Sunshine,notalk,FAIL,40000000,3688560,32030610,35719170
2007,tt0829482,Superbad,notalk,FAIL,17500000,121463226,169863226,291326452
2007,tt0815244,Sydney White,ok,PASS,16500000,11892415,13636339,25528754
2007,tt0780622,Teeth,dubious,FAIL,2000000,347578,2350641,2698219
2007,tt0825232,The Bucket List,notalk,FAIL,45000000,93466502,174310293,267776795
2007,tt0385752,The Golden Compass,ok,PASS,205000000,70107728,372234864,442342592
2007,tt0419887,The Kite Runner,nowomen,FAIL,20000000,15800078,74180745,89980823
2007,tt0756683,The Man from Earth,notalk,FAIL,200000,N/A,N/A,#VALUE!
2007,tt0425430,The Messengers,ok,PASS,16000000,35374833,53774833,89149666
2007,tt0884328,The Mist,ok,PASS,13000000,25593755,54777490,80371245
2007,tt0481369,The Number 23,notalk,FAIL,32000000,35193167,77593167,112786334
2007,tt0775529,The Savages,ok,PASS,9000000,6623082,10642023,17265105
2007,tt0780607,The Signal,men,FAIL,50000,251150,406299,657449
2007,tt0462538,The Simpsons Movie,ok,PASS,72500000,183135014,527071022,710206036
2007,tt0857191,The Visitor,dubious,FAIL,4000000,9427026,19174817,28601843
2007,tt0469494,There Will Be Blood,nowomen,FAIL,25000000,40222514,77208711,117431225
2007,tt0453556,TMNT,notalk,FAIL,35000000,54149098,96096018,150245116
2007,tt0418279,Transformers,notalk,FAIL,151000000,319246193,708272592,1027518785
2007,tt0861739,Tropa de Elite,ok,PASS,6537890,8744,14319195,14327939
2007,tt0473308,Waitress,ok,PASS,1500000,19097550,22217183,41314733
2007,tt0498399,We Own the Night,nowomen,FAIL,28000000,28563179,55307857,83871036
2007,tt0496436,White Noise 2: The Light,notalk,FAIL,10000000,N/A,8243567,#VALUE!
2006,tt0416449,300,nowomen,FAIL,60000000,210614939,454161935,664776874
2006,tt0405296,A Scanner Darkly,notalk,FAIL,20000000,5501616,7405084,12906700
2006,tt0437800,Akeelah and the Bee,ok,PASS,8000000,18848430,18959424,37807854
2006,tt0429591,Aquamarine,ok,PASS,12000000,18597342,22978953,41576295
2006,tt0416496,Bandidas,ok,PASS,35000000,N/A,18400000,#VALUE!
2006,tt0454082,Black Christmas,ok,PASS,9000000,16235738,16235738,32471476
2006,tt0450259,Blood Diamond,notalk,FAIL,100000000,57377916,171377916,228755832
2006,tt0479647,"Bon Cop, Bad Cop",notalk,FAIL,8000000,12671300,12671300,25342600
2006,tt0443453,Borat: Cultural Learnings of America for Make Benefit Glorious Nation of Kazakhstan,notalk,FAIL,18000000,128505958,261572744,390078702
2006,tt0470705,Bug,ok,PASS,4000000,7006708,7006708,14013416
2006,tt0317219,Cars,notalk,FAIL,70000000,244082982,461667967,705750949
2006,tt0381061,Casino Royale,notalk,FAIL,102000000,167365000,596365000,763730000
2006,tt0206634,Children of Men,ok,PASS,76000000,35552383,69450202,105002585
2006,tt0424345,Clerks II,dubious,FAIL,5000000,24148068,25894473,50042541
2006,tt0479884,Crank,nowomen,FAIL,12000000,27838408,43924923,71763331
2006,tt0405094,Das Leben Der Anderen,nowomen,FAIL,2000000,11284657,81197047,92481704
2006,tt0398913,DOA: Dead or Alive,ok,PASS,30000000,480314,7756224,8236538
2006,tt0457430,El laberinto del fauno (Pan's Labyrinth),ok,PASS,16000000,37634615,87041569,124676184
2006,tt0449010,Eragon,notalk,FAIL,100000000,75030163,249488115,324518278
2006,tt0457572,Fido,men,FAIL,8000000,298110,419801,717911
2006,tt0414982,Final Destination 3,ok,PASS,25000000,54098051,112798051,166896102
2006,tt0424095,Flushed Away,nowomen,FAIL,149000000,64665672,177665672,242331344
2006,tt0470765,For Your Consideration,ok,PASS,12000000,5549923,5549923,11099846
2006,tt0436331,Friends with Money,ok,PASS,6500000,13368437,17518322,30886759
2006,tt0438097,Ice Age: The Meltdown,notalk,FAIL,75000000,195330621,651899282,847229903
2006,tt0417225,Idlewild,ok,PASS,15000000,12669914,12669914,25339828
2006,tt0454848,Inside Man,dubious,FAIL,50000000,88634237,184634237,273268474
2006,tt0493430,Jackass Number Two,notalk,FAIL,11000000,72778712,85278712,158057424
2006,tt0452637,Lady in the Water,men,FAIL,75000000,42285169,72785169,115070338
2006,tt0408985,Last Holiday,ok,PASS,45000000,38399961,43343247,81743208
2006,tt0498380,Letters from Iwo Jima,notalk,FAIL,13000000,13756082,68756082,82512164
2006,tt0404203,Little Children,ok,PASS,14000000,5463019,14763019,20226038
2006,tt0449059,Little Miss Sunshine,ok,PASS,8000000,59891098,100550977,160442075
2006,tt0490166,London To Brighton,ok,PASS,825000,N/A,610776,#VALUE!
2006,tt0425210,Lucky Number Slevin,notalk,FAIL,27000000,22495466,55495466,77990932
2006,tt0483726,Man of the Year,notalk,FAIL,20000000,37442180,41342180,78784360
2006,tt0422720,Marie Antoinette,ok,PASS,40000000,15962471,60862471,76824942
2006,tt0482546,Miss Potter,ok,PASS,30000000,3005605,35891257,38896862
2006,tt0385880,Monster House,ok,PASS,75000000,73661010,141267370,214928380
2006,tt0457510,Nacho Libre,nowomen,FAIL,32000000,80197993,99296462,179494455
2006,tt0477347,Night at the Museum,ok,PASS,110000000,250863268,574480841,825344109
2006,tt0465551,Notes on a Scandal,ok,PASS,27500000,17510118,49752391,67262509
2006,tt0907657,Once,men,FAIL,150000,9445857,18997174,28443031
2006,tt0400717,Open Season,notalk,FAIL,85000000,85105259,189901703,275006962
2006,tt0401711,Paris je t&#39;aime,dubious,FAIL,13000000,4857374,4857374,9714748
2006,tt0396171,Perfume: The Story of a Murderer,ok,PASS,63700000,2223293,133603463,135826756
2006,tt0383574,Pirates of the Caribbean: Dead Man&#39;s Chest,men,FAIL,225000000,423315812,1060615812,1483931624
2006,tt0409182,Poseidon,men,FAIL,160000000,60674817,181674817,242349634
2006,tt0451176,Quinceanera,ok,PASS,400000,1692693,2522787,4215480
2006,tt0405508,Rang De Basanti,ok,PASS,5300000,2197694,29197694,31395388
2006,tt0439289,Running with Scissors,ok,PASS,12000000,6860000,8706701,15566701
2006,tt0454945,She&#39;s the Man,men,FAIL,25000000,33889159,55279608,89168767
2006,tt0423169,Sherrybaby,dubious,FAIL,2000000,199176,622806,821982
2006,tt0367027,Shortbus,ok,PASS,2000000,1985292,1985292,3970584
2006,tt0384537,Silent Hill,ok,PASS,50000000,46982632,99982632,146965264
2006,tt0439815,Slither,ok,PASS,15250000,7802450,12930343,20732793
2006,tt0475394,Smokin&#39; Aces,dubious,FAIL,17000000,35662731,56047261,91709992
2006,tt0417148,Snakes on a Plane,ok,PASS,33000000,34020814,62020814,96041628
2006,tt0405336,Southland Tales,ok,PASS,17000000,275380,364607,639987
2006,tt0430634,Stick It,ok,PASS,20000000,26910736,30399714,57310450
2006,tt0420223,Stranger Than Fiction,ok,PASS,30000000,40435190,45235190,85670380
2006,tt0348150,Superman Returns,notalk,FAIL,232000000,200120000,390874000,590994000
2006,tt0446046,Take the Lead,ok,PASS,30000000,34742066,65390493,100132559
2006,tt0429589,The Ant Bully,men,FAIL,45000000,28142535,49610898,77753433
2006,tt0452594,The Break Up,notalk,FAIL,52000000,118806699,202944203,321750902
2006,tt0382625,The Da Vinci Code,notalk,FAIL,125000000,217536138,767820459,985356597
2006,tt0783238,The Dead Girl,ok,PASS,3300000,19875,19875,39750
2006,tt0407887,The Departed,notalk,FAIL,90000000,133311000,290539042,423850042
2006,tt0458352,The Devil Wears Prada,ok,PASS,35000000,124740460,326551094,451291554
2006,tt0414993,The Fountain,dubious,FAIL,35000000,10144010,15461638,25605648
2006,tt0433386,The Grudge 2,ok,PASS,20000000,39143839,70743839,109887678
2006,tt0464049,The History Boys,notalk,FAIL,3700000,2730296,13425589,16155885
2006,tt0457939,The Holiday,ok,PASS,85000000,63280000,205190324,268470324
2006,tt0468492,The Host,ok,PASS,50000000,26623701,58188384,84812085
2006,tt0443543,The Illusionist,nowomen,FAIL,16500000,39868642,83792062,123660704
2006,tt0410297,The Lake House,dubious,FAIL,40000000,52330111,114830111,167160222
2006,tt0446755,The Painted Veil,dubious,FAIL,19400000,8060487,15118795,23179282
2006,tt0482571,The Prestige,notalk,FAIL,40000000,53089891,107896006,160985897
2006,tt0454921,The Pursuit of Happyness,nowomen,FAIL,55000000,162586036,307325633,469911669
2006,tt0436697,The Queen,dubious,FAIL,15000000,56441711,128885873,185327584
2006,tt0460989,The Wind That Shakes the Barley,notalk,FAIL,8300000,1829142,25670174,27499316
2006,tt0370032,Ultraviolet,notalk,FAIL,30000000,18522064,20722064,39244128
2006,tt0441909,Volver,ok,PASS,9400000,12899867,85599867,98499734
2006,tt0758794,We Are Marshall,notalk,FAIL,65000000,43545364,43545364,87090728
2006,tt0455857,When a Stranger Calls,ok,PASS,15000000,47860214,66944472,114804686
2006,tt0477139,Wristcutters: A Love Story,notalk,FAIL,1000000,446165,460136,906301
2006,tt0376994,X-Men: The Last Stand,ok,PASS,210000000,234362462,459359555,693722017
2006,tt0463034,"You, Me and Dupree",notalk,FAIL,54000000,75802010,130402010,206204020
2006,tt0383060,Zoom,ok,PASS,35000000,11989328,12506188,24495516
2006,tt0389557,Zwartboek,ok,PASS,22000000,4398532,27238354,31636886
2005,tt0402022,AEon Flux,ok,PASS,55000000,25857987,47953341,73811328
2005,tt0398712,Assault on Precinct 13,ok,PASS,30000000,20040895,36040895,56081790
2005,tt0372784,Batman Begins,notalk,FAIL,150000000,205343774,373298774,578642548
2005,tt0388500,Beauty Shop,ok,PASS,25000000,36351350,38351350,74702700
2005,tt0374536,Bewitched,ok,PASS,80000000,63313159,131159306,194472465
2005,tt0383222,BloodRayne,dubious,FAIL,25000000,2405420,3605420,6010840
2005,tt0357507,Boogeyman,men,FAIL,20000000,46752382,67192859,113945241
2005,tt0439478,Boynton Beach Club,ok,PASS,2900000,3127472,3127472,6254944
2005,tt0393109,Brick,notalk,FAIL,450000,2075743,4087493,6163236
2005,tt0388795,Brokeback Mountain,notalk,FAIL,13900000,83043761,174097801,257141562
2005,tt0379725,Capote,dubious,FAIL,7000000,28750530,49924079,78674609
2005,tt0367594,Charlie and the Chocolate Factory,ok,PASS,150000000,206459076,474459076,680918152
2005,tt0451094,Chinjeolhan geumjassi,ok,PASS,4500000,211667,23471871,23683538
2005,tt0352248,Cinderella Man,men,FAIL,88000000,61649911,108539911,170189822
2005,tt0393162,Coach Carter,ok,PASS,45000000,67264877,76669806,143934683
2005,tt0360486,Constantine,notalk,FAIL,75000000,75976178,230884728,306860906
2005,tt0435623,Conversations with Other Women,nowomen,FAIL,450000,379418,909061,1288479
2005,tt0121164,Corpse Bride,dubious,FAIL,30000000,53359111,114770654,168129765
2005,tt0257516,Cursed,ok,PASS,35000000,19294901,25114901,44409802
2005,tt0342258,Danny the dog,notalk,FAIL,43000000,24537621,49037621,73575242
2005,tt0382628,Dark Water,ok,PASS,60000000,25473093,49473093,74946186
2005,tt0342272,Dear Wendy,notalk,FAIL,8000000,23106,446438,469544
2005,tt0421054,Domino,ok,PASS,50000000,10169202,22969202,33138404
2005,tt0419706,Doom,notalk,FAIL,70000000,28212337,54612337,82824674
2005,tt0120667,Fantastic Four,notalk,FAIL,87500000,154696080,330717080,485413160
2005,tt0408790,Flightplan,ok,PASS,55000000,89706988,225706988,315413976
2005,tt0369441,Fun with Dick and Jane,ok,PASS,140000000,110550000,201798116,312348116
2005,tt0433383,"Good Night, and Good Luck.",notalk,FAIL,7000000,31501218,56586901,88088119
2005,tt0424136,Hard Candy,ok,PASS,950000,1024640,8267066,9291706
2005,tt0330373,Harry Potter and the Goblet of Fire,notalk,FAIL,150000000,290013036,896911078,1186924114
2005,tt0400497,Herbie Fully Loaded,ok,PASS,50000000,66010682,144110682,210121364
2005,tt0382077,Hide and Seek,ok,PASS,25000000,51100486,123100486,174200972
2005,tt0386588,Hitch,men,FAIL,55000000,177784257,366784257,544568514
2005,tt0443536,Hoodwinked!,ok,PASS,17500000,51386611,109843390,161230001
2005,tt0450278,Hostel,notalk,FAIL,4800000,47326473,82241110,129567583
2005,tt0410097,Hustle &amp; Flow,dubious,FAIL,2800000,22202809,23563727,45766536
2005,tt0396652,Ice Princess,ok,PASS,25000000,24381334,25732334,50113668
2005,tt0418763,Jarhead,nowomen,FAIL,72000000,62647540,96947540,159595080
2005,tt0418773,Junebug,ok,PASS,1000000,2678010,3557954,6235964
2005,tt0425123,Just Like Heaven,ok,PASS,58000000,48318130,100687083,149005213
2005,tt0360717,King Kong,nowomen,FAIL,207000000,218080025,550517357,768597382
2005,tt0320661,Kingdom of Heaven,nowomen,FAIL,110000000,47398413,218853353,266251766
2005,tt0373469,Kiss Kiss Bang Bang,notalk,FAIL,15000000,4235837,13105837,17341674
2005,tt0399295,Lord of War,men,FAIL,42000000,24149632,62142629,86292261
2005,tt0351283,Madagascar,nowomen,FAIL,75000000,193595521,556559566,750155087
2005,tt0331933,Man of the House,ok,PASS,50000000,19699706,22099706,41799412
2005,tt0416320,Match Point,ok,PASS,15000000,23089926,87989926,111079852
2005,tt0415978,Me and You and Everyone We Know,ok,PASS,2000000,3885134,8425527,12310661
2005,tt0397535,Memoirs of a Geisha,ok,PASS,85000000,57010853,161510853,218521706
2005,tt0366780,MirrorMask,ok,PASS,4000000,864959,963224,1828183
2005,tt0385307,Miss Congeniality 2: Armed &amp; Fabulous,ok,PASS,60000000,48478006,101382396,149860402
2005,tt0356910,Mr. &amp; Mrs. Smith,men,FAIL,110000000,186336279,478336279,664672558
2005,tt0408306,Munich,notalk,FAIL,75000000,47379090,130279090,177658180
2005,tt0395972,North Country,ok,PASS,30000000,18324242,25224242,43548484
2005,tt0380599,Oliver Twist,notalk,FAIL,65000000,2070920,26670920,28741840
2005,tt0414387,Pride and Prejudice,ok,PASS,28000000,38372662,120918508,159291170
2005,tt0377107,Proof,ok,PASS,20000000,7535331,8284331,15819662
2005,tt0421239,Red Eye,ok,PASS,26000000,57891803,95555805,153447608
2005,tt0294870,Rent,ok,PASS,40000000,29077547,31670620,60748167
2005,tt0358082,Robots,notalk,FAIL,80000000,128200012,260700012,388900024
2005,tt0432348,Saw II,dubious,FAIL,5000000,87025093,152925093,239950186
2005,tt0379786,Serenity,ok,PASS,39000000,25514517,38514517,64029034
2005,tt0338427,Shopgirl,men,FAIL,7500000,10284523,11758418,22042941
2005,tt0401792,Sin City,ok,PASS,40000000,74103820,158753820,232857640
2005,tt0474361,Sisters in Law,ok,PASS,300000,33312,33312,66624
2005,tt0405325,Sky High,ok,PASS,60000000,63939454,81627454,145566908
2005,tt0362165,Son of the Mask,notalk,FAIL,100000000,17018422,59918422,76936844
2005,tt0121766,Star Wars: Episode III - Revenge of the Sith,notalk,FAIL,115000000,380270577,848998877,1229269454
2005,tt0382992,Stealth,notalk,FAIL,138000000,32116746,76416746,108533492
2005,tt0369994,Strangers with Candy,ok,PASS,2000000,2072645,2077844,4150489
2005,tt0427944,Thank You for Smoking,notalk,FAIL,7500000,24793509,40016662,64810171
2005,tt0405422,The 40 Year Old Virgin,men,FAIL,26000000,109449237,177360047,286809284
2005,tt0424774,The Adventures of Sharkboy and Lavagirl 3-D,notalk,FAIL,50000000,39177684,69425966,108603650
2005,tt0384806,The Amityville Horror,ok,PASS,18500000,65233369,109175673,174409042
2005,tt0357110,The Ballad of Jack and Rose,ok,PASS,1500000,712294,1126258,1838552
2005,tt0363771,"The Chronicles of Narnia: The Lion, the Witch and the Wardrobe",ok,PASS,180000000,291710957,748806957,1040517914
2005,tt0387131,The Constant Gardener,ok,PASS,25500000,33579798,81079798,114659596
2005,tt0435625,The Descent,ok,PASS,7000000,26024456,57029609,83054065
2005,tt0395584,The Devil&#39;s Rejects,ok,PASS,7000000,17044981,20940428,37985409
2005,tt0404032,The Exorcism of Emily Rose,ok,PASS,18000000,75072454,144587700,219660154
2005,tt0432291,The Fog,ok,PASS,18000000,29511112,37048526,66559638
2005,tt0371724,The Hitchhiker&#39;s Guide to the Galaxy,notalk,FAIL,45000000,51019112,104019112,155038224
2005,tt0399201,The Island,ok,PASS,120000000,35818913,163018913,198837826
2005,tt0366627,The Jacket,men,FAIL,28500000,6301131,15452978,21754109
2005,tt0386140,The Legend of Zorro,notalk,FAIL,80000000,45575336,141475336,187050672
2005,tt0402399,The New World,dubious,FAIL,30000000,12712093,26184400,38896493
2005,tt0377109,The Ring Two,ok,PASS,50000000,75941727,161941727,237883454
2005,tt0397101,The Skeleton Key,ok,PASS,40000000,47907715,92256918,140164633
2005,tt0367089,The Squid and the Whale,men,FAIL,1500000,7372734,11191423,18564157
2005,tt0372532,The Wedding Date,ok,PASS,15000000,31726995,47175038,78902033
2005,tt0407265,Transamerica,ok,PASS,1000000,9015303,16553163,25568466
2005,tt0423409,Tristram Shandy: A Cock and Bull Story,men,FAIL,4750000,1253413,3061763,4315176
2005,tt0434409,V for Vendetta,ok,PASS,50000000,70511035,129231542,199742577
2005,tt0348333,Waiting...,ok,PASS,1125000,16124543,18673274,34797817
2005,tt0358273,Walk the Line,ok,PASS,29000000,119519402,187707495,307226897
2005,tt0407304,War of the Worlds,notalk,FAIL,132000000,234280354,606836535,841116889
2005,tt0240200,Water,ok,PASS,3000000,5529144,8119205,13648349
2005,tt0375210,White Noise,notalk,FAIL,10000000,56094360,92094360,148188720
2005,tt0443295,"Yours, Mine and Ours",ok,PASS,45000000,53359917,72359917,125719834
2005,tt0406375,Zathura: A Space Adventure,nowomen,FAIL,65000000,28045540,58545540,86591080
2004,tt0337563,13 Going on 30,ok,PASS,30000000,57139723,96439723,153579446
2004,tt0212712,2046,ok,PASS,12000000,1442338,19202856,20645194
2004,tt0343660,50 First Dates,men,FAIL,75000000,120776832,196324496,317101328
2004,tt0356470,A Cinderella Story,ok,PASS,19000000,51438175,70067909,121506084
2004,tt0359423,A Home at the End of The World,dubious,FAIL,6500000,1029017,1033810,2062827
2004,tt0344510,A Very Long Engagement,ok,PASS,55000000,6167817,59606587,65774404
2004,tt0357413,Anchorman: The Legend of Ron Burgundy,men,FAIL,25000000,84136909,89366354,173503263
2004,tt0327437,Around the World in 80 Days,notalk,FAIL,110000000,24004159,72004159,96008318
2004,tt0370263,AVP: Alien vs. Predator,dubious,FAIL,70000000,80281096,172543519,252824615
2004,tt0414852,Banlieue 13,nowomen,FAIL,15000000,1200216,11208291,12408507
2004,tt0381681,Before Sunset,nowomen,FAIL,2000000,5792822,11293790,17086612
2004,tt0317198,Bridget Jones: The Edge of Reason,ok,PASS,50000000,40203020,263894551,304097571
2004,tt0327554,Catwoman,ok,PASS,100000000,40202379,82145379,122347758
2004,tt0337921,Cellular,ok,PASS,45000000,32003620,61475984,93479604
2004,tt0376541,Closer,ok,PASS,35000000,33987757,115476509,149464266
2004,tt0369339,Collateral,nowomen,FAIL,60000000,100170152,217670152,317840304
2004,tt0345074,Connie and Carla,ok,PASS,20000000,8047525,8047525,16095050
2004,tt0375679,Crash,ok,PASS,7303082,55334418,101173038,156507456
2004,tt0367631,D.E.B.S.,ok,PASS,3500000,96793,96793,193586
2004,tt0363547,Dawn of the Dead,ok,PASS,28000000,58990765,103452875,162443640
2004,tt0364725,Dodgeball: A True Underdog Story,ok,PASS,30000000,114326736,167791704,282118440
2004,tt0327679,Ella Enchanted,ok,PASS,35000000,22913677,22913677,45827354
2004,tt0338013,Eternal Sunshine of the Spotless Mind,men,FAIL,20000000,34366518,72993444,107359962
2004,tt0349416,Eulogy,ok,PASS,10000000,70527,70527,141054
2004,tt0308644,Finding Neverland,ok,PASS,25000000,51676606,115036108,166712714
2004,tt0377062,Flight of the Phoenix,nowomen,FAIL,75000000,21009180,34009180,55018360
2004,tt0333766,Garden State,ok,PASS,2500000,26782316,36028802,62811118
2004,tt0366551,Harold and Kumar Go to White Castle,ok,PASS,9000000,18225165,18225165,36450330
2004,tt0304141,Harry Potter and the Prisoner of  Azkaban,ok,PASS,130000000,249538952,796688549,1046227501
2004,tt0167190,Hellboy,notalk,FAIL,60000000,59623958,99823958,159447916
2004,tt0299172,Home on the Range,ok,PASS,110000000,50026353,76482461,126508814
2004,tt0356721,I Heart Huckabees,ok,PASS,22000000,12784713,20034713,32819426
2004,tt0343818,"I, Robot",notalk,FAIL,105000000,144801023,348601023,493402046
2004,tt0385267,In Good Company,notalk,FAIL,26000000,45489752,63489752,108979504
2004,tt0362269,Kinsey,ok,PASS,11000000,10214647,13000959,23215606
2004,tt0373074,Kung Fu Hustle,nowomen,FAIL,20000000,17104669,101004669,118109338
2004,tt0375912,Layer Cake,notalk,FAIL,6500000,2339957,11850214,14190171
2004,tt0339291,Lemony Snicket&#39;s A Series of Unfortunate Events,ok,PASS,100000000,118627117,201627117,320254234
2004,tt0390221,Maria Full of Grace,ok,PASS,3200000,6529624,14441158,20970782
2004,tt0377092,Mean Girls,ok,PASS,18000000,86047227,130953026,217000253
2004,tt0405159,Million Dollar Baby,ok,PASS,30000000,100492203,232016402,332508605
2004,tt0349825,Miracle,notalk,FAIL,28000000,64378093,64474705,128852798
2004,tt0382189,My Summer of Love,ok,PASS,1700000,1000915,4951476,5952391
2004,tt0374900,Napoleon Dynamite,notalk,FAIL,400000,44540956,46122713,90663669
2004,tt0363282,New York Minute,notalk,FAIL,40000000,14018364,21215882,35234246
2004,tt0390384,Primer,notalk,FAIL,7000,424760,565846,990606
2004,tt0350028,Raising Helen,ok,PASS,50000000,37485528,43340302,80825830
2004,tt0350258,Ray,dubious,FAIL,40000000,75305995,124823094,200129089
2004,tt0318627,Resident Evil: Apocalypse,ok,PASS,50000000,50740078,128940078,179680156
2004,tt0332375,Saved!,ok,PASS,5000000,8886160,10228228,19114388
2004,tt0387564,Saw,men,FAIL,1200000,55185045,103096345,158281390
2004,tt0363988,Secret Window,notalk,FAIL,40000000,47958031,92111551,140069582
2004,tt0307453,Shark Tale,notalk,FAIL,75000000,161412000,367825111,529237111
2004,tt0365748,Shaun of the Dead,ok,PASS,5000000,13542874,30332385,43875259
2004,tt0298148,Shrek 2,ok,PASS,70000000,441226247,937008132,1378234379
2004,tt0375063,Sideways,ok,PASS,17000000,71502303,109874155,181376458
2004,tt0346156,Sky Captain and the World of Tomorrow,ok,PASS,70000000,37760080,49730854,87490934
2004,tt0371246,Spanglish,ok,PASS,75000000,42044321,54344321,96388642
2004,tt0316654,Spider-Man 2,notalk,FAIL,200000000,373524485,783705001,1157229486
2004,tt0372588,Team America: World Police,men,FAIL,20000000,32774834,50274834,83049668
2004,tt0338751,The Aviator,notalk,FAIL,110000000,102608827,214608827,317217654
2004,tt0372183,The Bourne Supremacy,men,FAIL,85000000,176087450,288587450,464674900
2004,tt0289879,The Butterfly Effect,men,FAIL,13000000,57924679,96046844,153971523
2004,tt0296572,The Chronicles of Riddick,men,FAIL,120000000,57712751,107212751,164925502
2004,tt0319262,The Day After Tomorrow,ok,PASS,125000000,186740799,556319450,743060249
2004,tt0391198,The Grudge,ok,PASS,10000000,110359362,187281115,297640477
2004,tt0317705,The Incredibles,ok,PASS,92000000,261441092,632107545,893548637
2004,tt0362270,The Life Aquatic with Steve Zissou,men,FAIL,50000000,24006726,34806726,58813452
2004,tt0332280,The Notebook,dubious,FAIL,30000000,81001787,102276787,183278574
2004,tt0293508,The Phantom of the Opera,men,FAIL,55000000,51225796,158225796,209451592
2004,tt0338348,The Polar Express,notalk,FAIL,170000000,194949659,319049659,513999318
2004,tt0368933,The Princess Diaries 2: Royal Engagement,ok,PASS,45000000,95149435,122071435,217220870
2004,tt0327162,The Stepford Wives,ok,PASS,100000000,59475623,96221971,155697594
2004,tt0362227,The Terminal,notalk,FAIL,75000000,77073959,218673959,295747918
2004,tt0368447,The Village,ok,PASS,71682975,114197520,257641634,371839154
2004,tt0327247,The Whole Ten Yards,notalk,FAIL,30000000,16323969,26323969,42647938
2004,tt0332452,Troy,notalk,FAIL,150000000,133298577,484161265,617459842
2004,tt0338526,Van Helsing,ok,PASS,170000000,120150546,300150546,420301092
2004,tt0383694,Vera Drake,ok,PASS,11000000,3753806,13353855,17107661
2004,tt0381707,White Chicks,ok,PASS,20000000,69148997,111448997,180597994
2004,tt0360201,Wimbledon,ok,PASS,35000000,16862585,41666476,58529061
2003,tt0322259,2 Fast 2 Furious,notalk,FAIL,76000000,127120058,236220058,363340116
2003,tt0315733,21 grams,dubious,FAIL,20000000,16248701,59667625,75916326
2003,tt0319061,Big Fish,notalk,FAIL,70000000,66432867,123432867,189865734
2003,tt0310778,Bon voyage,ok,PASS,20000000,2353728,8361736,10715464
2003,tt0315327,Bruce Almighty,ok,PASS,81000000,242704995,483473962,726178957
2003,tt0305357,Charlie&#39;s Angels: Full Throttle,ok,PASS,120000000,100814328,227200000,328014328
2003,tt0159365,Cold Mountain,ok,PASS,80000000,95632614,161632614,257265228
2003,tt0306685,Cradle 2 the Grave,notalk,FAIL,25000000,34657731,56434942,91092673
2003,tt0317303,Daddy Day Care,ok,PASS,60000000,104148781,164285587,268434368
2003,tt0287978,Daredevil,nowomen,FAIL,80000000,102543518,182782518,285326036
2003,tt0282209,Darkness Falls,notalk,FAIL,7000000,32539681,32539681,65079362
2003,tt0285531,Dreamcatcher,nowomen,FAIL,68000000,33685268,75685268,109370536
2003,tt0309593,Final Destination 2,ok,PASS,26000000,46896664,90396664,137293328
2003,tt0266543,Finding Nemo,notalk,FAIL,94000000,380529370,906465556,1286994926
2003,tt0322330,Freaky Friday,ok,PASS,26000000,110222438,160822438,271044876
2003,tt0335119,Girl with a Pearl Earring,ok,PASS,12000000,11634362,43281552,54915914
2003,tt0301357,Goodbye Lenin!,ok,PASS,6400000,4063859,79384539,83448398
2003,tt0311289,Holes,men,FAIL,20000000,67383924,72383924,139767848
2003,tt0329717,Hollywood Homicide,notalk,FAIL,75000000,30207785,51107785,81315570
2003,tt0315983,House of Sand and Fog,ok,PASS,16500000,13005485,16157923,29163408
2003,tt0251127,How to Lose a Guy in 10 Days,men,FAIL,50000000,105807520,177079973,282887493
2003,tt0286716,Hulk,notalk,FAIL,137000000,132177234,245229234,377406468
2003,tt0309698,Identity,notalk,FAIL,28000000,52131264,82183683,134314947
2003,tt0199626,In the Cut,ok,PASS,12000000,4717455,23693646,28411101
2003,tt0301470,Jeepers Creepers II,ok,PASS,25000000,35623801,35623801,71247602
2003,tt0266697,Kill Bill: Vol. 1,ok,PASS,55000000,70098138,180098138,250196276
2003,tt0325703,Lara Croft Tomb Raider: The Cradle of Life,nowomen,FAIL,90000000,65653758,156453758,222107516
2003,tt0333780,"Legally Blonde 2: Red, White &amp; Blonde",ok,PASS,25000000,90639088,125339088,215978176
2003,tt0286244,Les triplettes de Belleville,ok,PASS,2000000,7301288,14440113,21741401
2003,tt0335266,Lost In Translation,dubious,FAIL,4000000,44585453,112550685,157136138
2003,tt0314331,Love Actually,ok,PASS,45000000,59472278,247967903,307440181
2003,tt0311113,Master and Commander: The Far Side of the World,nowomen,FAIL,135000000,93926386,212912137,306838523
2003,tt0304415,Mona Lisa Smile,ok,PASS,65000000,63803100,141205169,205008269
2003,tt0340855,Monster,ok,PASS,5000000,34469210,58003694,92472904
2003,tt0327056,Mystic River,ok,PASS,30000000,90135191,156835191,246970382
2003,tt0316396,Peter Pan,ok,PASS,100000000,48417850,95255485,143673335
2003,tt0325980,Pirates of the Caribbean: The Curse of the Black Pearl,men,FAIL,125000000,305411224,634954103,940365327
2003,tt0366920,Pride and Prejudice,ok,PASS,28000000,38372662,120918508,159291170
2003,tt0257076,S.W.A.T.,ok,PASS,70000000,116877597,207154748,324032345
2003,tt0306047,Scary Movie 3,ok,PASS,45000000,110000082,155200000,265200082
2003,tt0327137,Secondhand Lions,notalk,FAIL,30000000,42070939,47902566,89973505
2003,tt0300471,Shanghai Knights,notalk,FAIL,50000000,60470220,88316835,148787055
2003,tt0323944,Shattered Glass,men,FAIL,6000000,2207975,2932719,5140694
2003,tt0165982,Sinbad: Legend of the Seven Seas,men,FAIL,60000000,26483452,80767884,107251336
2003,tt0337741,Something&#39;s Gotta Give,dubious,FAIL,80000000,124685242,266685242,391370484
2003,tt0338459,Spy Kids 3-D: Game Over,ok,PASS,40000000,111760631,167851995,279612626
2003,tt0324133,Swimming Pool,ok,PASS,7800000,10130108,22441323,32571431
2003,tt0181852,Terminator 3: Rise of the Machines,ok,PASS,170000000,150358296,433058296,583416592
2003,tt0298814,The Core,ok,PASS,85000000,31111260,74132631,105243891
2003,tt0317740,The Italian Job,notalk,FAIL,60000000,106126012,176262839,282388851
2003,tt0283426,The Jungle Book 2,nowomen,FAIL,20000000,47901582,135703599,183605181
2003,tt0325710,The Last Samurai,nowomen,FAIL,140000000,111110575,456810575,567921150
2003,tt0311429,The League of Extraordinary Gentlemen,nowomen,FAIL,78000000,66465204,179265204,245730408
2003,tt0167260,The Lord of the Rings: The Return of the King,notalk,FAIL,94000000,377845905,1141408667,1519254572
2003,tt0234215,The Matrix Reloaded,ok,PASS,127000000,281553689,738576929,1020130618
2003,tt0242653,The Matrix Revolutions,ok,PASS,110000000,139259759,424259759,563519518
2003,tt0338188,The Missing,ok,PASS,65000000,26900336,38253433,65153769
2003,tt0332379,The School of Rock,dubious,FAIL,20000000,81261177,131161177,212422354
2003,tt0328538,Thirteen,ok,PASS,2000000,4601043,9505996,14107039
2003,tt0300556,Timeline,notalk,FAIL,80000000,19480739,26703184,46183923
2003,tt0339840,Undead,ok,PASS,750000,41196,229250,270446
2003,tt0320691,Underworld,dubious,FAIL,22000000,51970690,95708457,147679147
2003,tt0295700,Wrong Turn,ok,PASS,10000000,15417771,28649556,44067327
2003,tt0290334,X2 (X-Men 2),ok,PASS,125000000,214949694,407711549,622661243
2002,tt0307901,25th Hour,men,FAIL,4500000,13084595,25344490,38429085
2002,tt0289043,28 Days Later...,ok,PASS,8000000,45064915,82955633,128020548
2002,tt0283832,8 femmes,ok,PASS,8000000,3076425,42376425,45452850
2002,tt0298203,8 Mile,notalk,FAIL,41000000,116724075,242924075,359648150
2002,tt0257360,About Schmidt,notalk,FAIL,30000000,65005217,105823486,170828703
2002,tt0268126,Adaptation,dubious,FAIL,18500000,22498520,22498520,44997040
2002,tt0286261,All or Nothing,ok,PASS,9000000,184255,184255,368510
2002,tt0168786,Antwone Fisher,notalk,FAIL,12500000,21078145,23367586,44445731
2002,tt0295178,Austin Powers in Goldmember,notalk,FAIL,63000000,213117789,292738626,505856415
2002,tt0286499,Bend It Like Beckham,ok,PASS,5600000,32543449,76730377,109273826
2002,tt0187738,Blade II,notalk,FAIL,54000000,81676888,154338601,236015489
2002,tt0300532,Blue Crush,ok,PASS,30000000,40118420,51618420,91736840
2002,tt0303816,Cabin Fever,ok,PASS,1500000,21158188,30351664,51509852
2002,tt0319970,Carrie,ok,PASS,30000000,35266619,85001659,120268278
2002,tt0264464,Catch Me If You Can,notalk,FAIL,52000000,164606800,351106800,515713600
2002,tt0299658,Chicago,ok,PASS,30000000,170687518,307687518,478375036
2002,tt0275022,Crossroads,ok,PASS,12000000,37188667,57000000,94188667
2002,tt0266452,Death to Smoochy,men,FAIL,50000000,8355815,8374062,16729877
2002,tt0246460,Die Another Day,men,FAIL,142000000,160942139,431942139,592884278
2002,tt0303933,Drumline,notalk,FAIL,20000000,56398162,56398162,112796324
2002,tt0238380,Equilibrium,notalk,FAIL,20000000,1190018,5345869,6535887
2002,tt0297884,Far from Heaven,ok,PASS,13500000,15901849,29027914,44929763
2002,tt0120679,Frida,men,FAIL,12000000,25885000,55710675,81595675
2002,tt0327753,Funny Ha Ha,ok,PASS,30000,77070,77070,154140
2002,tt0217505,Gangs of New York,notalk,FAIL,97000000,77730500,190400000,268130500
2002,tt0302674,Gerry,nowomen,FAIL,7000000,254683,254683,509366
2002,tt0295297,Harry Potter and the Chamber of Secrets,ok,PASS,100000000,261987880,878979634,1140967514
2002,tt0257756,High Crimes,ok,PASS,42000000,41543207,63781100,105324307
2002,tt0297181,I Spy,notalk,FAIL,70000000,33561137,60279822,93840959
2002,tt0268380,Ice Age,nowomen,FAIL,65000000,176387405,386116343,562503748
2002,tt0280760,Igby Goes Down,men,FAIL,9000000,4777465,4777465,9554930
2002,tt0278504,Insomnia,notalk,FAIL,46000000,67263182,113622499,180885681
2002,tt0275847,Lilo and Stitch,ok,PASS,80000000,145771527,245800000,391571527
2002,tt0252076,Maid in Manhattan,ok,PASS,55000000,93932896,163838217,257771113
2002,tt0303361,May,ok,PASS,1750000,145540,497339,642879
2002,tt0120912,Men in Black II,notalk,FAIL,140000000,190418803,441767803,632186606
2002,tt0181689,Minority Report,notalk,FAIL,102000000,132024714,358824714,490849428
2002,tt0280590,Mr Deeds,men,FAIL,50000000,126293452,171269535,297562987
2002,tt0259446,My Big Fat Greek Wedding,ok,PASS,5000000,241438208,352242522,593680730
2002,tt0258000,Panic Room,ok,PASS,48000000,95308367,196308367,291616734
2002,tt0183649,Phone Booth,notalk,FAIL,11000000,46566212,97837138,144403350
2002,tt0238546,Queen of the Damned,ok,PASS,35000000,30307804,30307804,60615608
2002,tt0252444,Rabbit-Proof Fence,ok,PASS,7000000,6199600,16866928,23066528
2002,tt0296166,Real Women Have Curves,ok,PASS,3000000,5853194,5853194,11706388
2002,tt0289765,Red Dragon,notalk,FAIL,78000000,92955420,206455420,299410840
2002,tt0253556,Reign of Fire,notalk,FAIL,60000000,43061982,82150183,125212165
2002,tt0120804,Resident Evil,ok,PASS,35000000,40119709,103787401,143907110
2002,tt0267913,Scooby-Doo,ok,PASS,84000000,153294164,276294164,429588328
2002,tt0286106,Signs,notalk,FAIL,70702619,227965690,408265690,636231380
2002,tt0281373,Snow Dogs,notalk,FAIL,32000000,81150692,116898028,198048720
2002,tt0307479,Solaris,notalk,FAIL,47000000,14970038,14970038,29940076
2002,tt0145487,Spider-Man,notalk,FAIL,139000000,403706375,821565375,1225271750
2002,tt0166813,Spirit: Stallion of the Cimarron,nowomen,FAIL,80000000,73215310,106515310,179730620
2002,tt0283003,Spun,ok,PASS,4500000,410241,1022649,1432890
2002,tt0287717,Spy Kids 2: Island of Lost Dreams,ok,PASS,38000000,85846296,119721296,205567592
2002,tt0253754,Star Trek: Nemesis,notalk,FAIL,60000000,43254409,67312826,110567235
2002,tt0121765,Star Wars: Episode II - Attack of the Clones,dubious,FAIL,115000000,310676740,656695615,967372355
2002,tt0180052,The Adventures of Pluto Nash,men,FAIL,100000000,4411102,7094995,11506097
2002,tt0280460,The Banger Sisters,ok,PASS,10000000,30306281,38067218,68373499
2002,tt0258463,The Bourne Identity,notalk,FAIL,60000000,121468960,213300000,334768960
2002,tt0238924,The Dangerous Lives of Altar Boys,notalk,FAIL,12000000,1779284,1779284,3558568
2002,tt0279113,The Good Girl,ok,PASS,8000000,14018296,16856124,30874420
2002,tt0274558,The Hours,ok,PASS,25000000,41675994,97030468,138706462
2002,tt0278500,The Importance of Being Earnest,ok,PASS,15000000,8378141,8378141,16756282
2002,tt0167261,The Lord of the Rings: The Two Towers,notalk,FAIL,94000000,342548984,927048984,1269597968
2002,tt0289408,The Powerpuff Girls,ok,PASS,25000000,11411644,16425701,27837345
2002,tt0258068,The Quiet American,men,FAIL,20000000,12987647,26348203,39335850
2002,tt0298130,The Ring,ok,PASS,48000000,129094024,248218486,377312510
2002,tt0292644,The Rules of Attraction,dubious,FAIL,4000000,6525762,11799060,18324822
2002,tt0304669,The Santa Clause 2,notalk,FAIL,65000000,139225854,172825854,312051708
2002,tt0253867,The Sweetest Thing,ok,PASS,43000000,24430272,44633441,69063713
2002,tt0293662,The Transporter,nowomen,FAIL,21000000,25296447,43928932,69225379
2002,tt0290095,The Tuxedo,nowomen,FAIL,60000000,50586000,104429625,155015625
2002,tt0133240,Treasure Planet,notalk,FAIL,100000000,38120554,91800000,129920554
2002,tt0283084,Tuck Everlasting,ok,PASS,15000000,19161999,19344615,38506614
2002,tt0313737,Two Weeks Notice,ok,PASS,60000000,93354918,199043309,292398227
2002,tt0277434,We Were Soldiers,ok,PASS,70000000,78120196,114658262,192778458
2002,tt0298228,Whale Rider,ok,PASS,4300000,20779666,39892476,60672142
2002,tt0283139,White Oleander,ok,PASS,16000000,16357770,21657770,38015540
2002,tt0295701,xXx,notalk,FAIL,70000000,141930000,267200000,409130000
2001,tt0268978,A Beautiful Mind,notalk,FAIL,78000000,170708996,317668058,488377054
2001,tt0183790,A Knight&#39;s Tale,men,FAIL,41000000,56083966,100622586,156706552
2001,tt0164334,Along Came A Spider,ok,PASS,28000000,74058698,105159085,179217783
2001,tt0244000,American Outlaws,notalk,FAIL,35000000,13264986,13264986,26529972
2001,tt0218817,Antitrust,men,FAIL,30000000,10965209,17865209,28830418
2001,tt0212720,Artificial Intelligence: AI,notalk,FAIL,90000000,78616689,235900000,314516689
2001,tt0230011,Atlantis: The Lost Empire,notalk,FAIL,90000000,84052762,186049020,270101782
2001,tt0265086,Black Hawk Down,nowomen,FAIL,95000000,108638745,159691085,268329830
2001,tt0221027,Blow,notalk,FAIL,30000000,52990775,83282296,136273071
2001,tt0243155,Bridget Jones&#39;s Diary,ok,PASS,25000000,71500556,281527158,353027714
2001,tt0260866,Don&#39;t Say A Word,ok,PASS,50000000,54997476,104488383,159485859
2001,tt0246578,Donnie Darko,dubious,FAIL,4500000,1270522,7696529,8967051
2001,tt0240462,Dr. Dolittle 2,ok,PASS,72000000,112950721,176101721,289052442
2001,tt0251075,Evolution,ok,PASS,80000000,38311134,98341932,136653066
2001,tt0120681,From Hell,dubious,FAIL,35000000,31598308,68712365,100310673
2001,tt0162346,Ghost World,ok,PASS,5500000,6217849,8761608,14979457
2001,tt0280707,Gosford Park,ok,PASS,18000000,41300105,41300105,82600210
2001,tt0212985,Hannibal,ok,PASS,87000000,165092266,350100280,515192546
2001,tt0241527,Harry Potter and the Sorcerer&#39;s Stone,ok,PASS,125000000,317575550,974755371,1292330921
2001,tt0248845,Hedwig and the Angry Inch,ok,PASS,6000000,3067312,3643900,6711212
2001,tt0253126,High Heels and Low Lifes,ok,PASS,10000000,226792,226792,453584
2001,tt0160399,Impostor,nowomen,FAIL,40000000,6114237,6114237,12228474
2001,tt0211443,Jason X,ok,PASS,14000000,13121555,16951798,30073353
2001,tt0261392,Jay and Silent Bob Strike Back,ok,PASS,22000000,30059386,33762400,63821786
2001,tt0263488,Jeepers Creepers,ok,PASS,10000000,37904175,58939035,96843210
2001,tt0236348,Josie and the Pussycats,ok,PASS,22000000,14252830,14252830,28505660
2001,tt0035423,Kate &amp; Leopold,men,FAIL,48000000,47095453,70937778,118033231
2001,tt0271027,Kiss of the Dragon,notalk,FAIL,25000000,36833473,36833473,73666946
2001,tt0264761,Kissing Jessica Stein,ok,PASS,1500000,7025722,8831884,15857606
2001,tt0242587,L.I.E.,notalk,FAIL,700000,1140965,1140965,2281930
2001,tt0146316,Lara Croft: Tomb Raider,nowomen,FAIL,94000000,131144183,274644183,405788366
2001,tt0250494,Legally Blonde,ok,PASS,18000000,96493426,141809235,238302661
2001,tt0258273,Lovely and Amazing,ok,PASS,250000,4210379,4695781,8906160
2001,tt0166276,Monkeybone,dubious,FAIL,75000000,5409517,5409517,10819034
2001,tt0265343,Monsoon Wedding,ok,PASS,1200000,13876974,27025600,40902574
2001,tt0198781,"Monsters, Inc.",notalk,FAIL,115000000,289423425,559757719,849181144
2001,tt0203009,Moulin Rouge!,ok,PASS,53000000,57386369,179213196,236599565
2001,tt0166924,Mulholland Dr.,ok,PASS,15000000,7219578,11919578,19139156
2001,tt0161860,Nowhere in Africa,ok,PASS,6500000,6173485,6173485,12346970
2001,tt0240772,Ocean&#39;s Eleven,notalk,FAIL,85000000,183417150,450728529,634145679
2001,tt0181739,Osmosis Jones,dubious,FAIL,70000000,13596911,13596911,27193822
2001,tt0213149,Pearl Harbor,men,FAIL,151500000,198539855,449239855,647779710
2001,tt0206275,Save the Last Dance,ok,PASS,13000000,91038276,131638276,222676552
2001,tt0256380,Shallow Hal,ok,PASS,40000000,70836296,70836296,141672592
2001,tt0286112,Shaolin Soccer,nowomen,FAIL,10000000,488872,42776032,43264904
2001,tt0126029,Shrek,notalk,FAIL,50000000,267655011,491812794,759467805
2001,tt0244970,Someone Like You...,ok,PASS,23000000,27338033,38684906,66022939
2001,tt0227538,Spy Kids,ok,PASS,35000000,112692062,197692062,310384124
2001,tt0247745,Super Troopers,notalk,FAIL,3000000,18492362,23046142,41538504
2001,tt0232500,The Fast and the Furious,notalk,FAIL,38000000,144512310,206512310,351024620
2001,tt0221218,The Glass House,ok,PASS,22000000,17951431,22861785,40813216
2001,tt0290879,The Legend of Suriyothai,ok,PASS,9000000,454255,454255,908510
2001,tt0120737,The Lord of the Rings: The Fellowship of the Ring,notalk,FAIL,109000000,315544750,887217688,1202762438
2001,tt0268995,The Majestic,notalk,FAIL,72000000,27796042,37306334,65102376
2001,tt0267804,The One,nowomen,FAIL,49000000,43905746,43905746,87811492
2001,tt0230600,The Others,ok,PASS,17000000,96522687,209947037,306469724
2001,tt0247638,The Princess Diaries,ok,PASS,30000000,108244774,165334774,273579548
2001,tt0265666,The Royal Tenenbaums,ok,PASS,28000000,52353636,71430876,123784512
2001,tt0209475,The Wedding Planner,ok,PASS,28000000,60400856,94728529,155129385
2001,tt0245674,Thir13en Ghosts,notalk,FAIL,19000000,41867960,68467960,110335920
2001,tt0139654,Training Day,notalk,FAIL,45000000,76261036,104505362,180766398
2001,tt0242998,Valentine,men,FAIL,10000000,20384136,20384136,40768272
2001,tt0259711,Vanilla Sky,notalk,FAIL,70000000,100614858,202726605,303341463
2001,tt0196229,Zoolander,ok,PASS,28000000,45172250,60780981,105953231
2000,tt0191754,28 Days,ok,PASS,43000000,37035515,62063972,99099487
2000,tt0181875,Almost Famous,ok,PASS,60000000,32522352,47371191,79893543
2000,tt0144084,American Psycho,notalk,FAIL,8000000,15070285,28674417,43744702
2000,tt0221889,Beautiful Creatures,ok,PASS,50000000,19452138,55940671,75392809
2000,tt0218839,Best in Show,ok,PASS,6000000,18621249,20695413,39316662
2000,tt0249462,Billy Elliot,ok,PASS,5000000,21995263,109280263,131275526
2000,tt0181984,Boiler Room,notalk,FAIL,9000000,16963963,28773637,45737600
2000,tt0204946,Bring It On,ok,PASS,10000000,68353550,90453550,158807100
2000,tt0162222,Cast Away,notalk,FAIL,85000000,233632142,427230516,660862658
2000,tt0173716,Cecil B. Demented,ok,PASS,10000000,1276984,1953882,3230866
2000,tt0210616,Center Stage,ok,PASS,18000000,17200925,17200925,34401850
2000,tt0160127,Charlie&#39;s Angels,ok,PASS,90000000,125305545,259736090,385041635
2000,tt0120630,Chicken Run,ok,PASS,42000000,106793915,227793915,334587830
2000,tt0241303,Chocolat,ok,PASS,25000000,71309760,152500343,223810103
2000,tt0200550,Coyote Ugly,men,FAIL,45000000,60786269,115786269,176572538
2000,tt0168629,Dancer in the Dark,ok,PASS,12500000,4157491,45557491,49714982
2000,tt0242423,"Dude, Where&#39;s My Car",men,FAIL,14000000,46729374,73180297,119909671
2000,tt0142032,Dune,ok,PASS,45000000,27447471,27447471,54894942
2000,tt0195685,Erin Brockovich,ok,PASS,50000000,125548685,257805243,383353928
2000,tt0195714,Final Destination,notalk,FAIL,23000000,53302314,112036870,165339184
2000,tt0172495,Gladiator,nowomen,FAIL,103000000,187683805,457683805,645367610
2000,tt0187078,Gone in Sixty Seconds,notalk,FAIL,103300000,101643008,232643008,334286016
2000,tt0146882,High Fidelity,men,FAIL,20000000,27277055,47881663,75158718
2000,tt0164052,Hollow Man,ok,PASS,90000000,73209340,191200000,264409340
2000,tt0185431,Little Nicky,notalk,FAIL,80000000,39442871,58270391,97713262
2000,tt0199725,Love &amp; Basketball,ok,PASS,15000000,27441122,27709625,55150747
2000,tt0212338,Meet the Parents,men,FAIL,55000000,166225040,304599899,470824939
2000,tt0209144,Memento,notalk,FAIL,5000000,25544867,39723096,65267963
2000,tt0212346,Miss Congeniality,ok,PASS,45000000,106807667,213420951,320228618
2000,tt0183523,Mission to Mars,notalk,FAIL,90000000,60874615,106000000,166874615
2000,tt0190590,"O Brother, Where Art Thou?",nowomen,FAIL,26000000,45506619,75763814,121270433
2000,tt0134847,Pitch Black,ok,PASS,23000000,39235088,53182088,92417176
2000,tt0257001,Pokemon: The Movie 2000,men,FAIL,30000000,43746923,133946923,177693846
2000,tt0199753,Red Planet,nowomen,FAIL,80000000,17480890,33463969,50944859
2000,tt0210945,Remember the Titans,notalk,FAIL,30000000,115654751,136706683,252361434
2000,tt0180093,Requiem for a Dream,ok,PASS,4500000,3635482,7390108,11025590
2000,tt0122459,Return to Me,dubious,FAIL,24000000,32662299,32662299,65324598
2000,tt0165929,Romeo Must Die,nowomen,FAIL,25000000,55973336,91036760,147010096
2000,tt0213203,Rugrats in Paris:,ok,PASS,30000000,76501438,103284813,179786251
2000,tt0195234,Saving Grace,ok,PASS,4000000,12178602,27786849,39965451
2000,tt0134084,Scream 3,ok,PASS,40000000,89138076,161838076,250976152
2000,tt0203119,Sexy Beast,men,FAIL,4300000,6946056,10154577,17100633
2000,tt0184894,Shanghai Noon,notalk,FAIL,55000000,56932305,71189835,128122140
2000,tt0208092,Snatch.,nowomen,FAIL,10000000,30093107,83593107,113686214
2000,tt0210299,Songcatcher,ok,PASS,1800000,3050934,3050934,6101868
2000,tt0163978,The Beach,notalk,FAIL,50000000,39778599,39778599,79557198
2000,tt0209958,The Cell,men,FAIL,35000000,61280963,85911226,147192189
2000,tt0120917,The Emperor&#39;s New Groove,ok,PASS,100000000,89296573,169296573,258593146
2000,tt0219699,The Gift,dubious,FAIL,10000000,12008642,44567606,56576248
2000,tt0187393,The Patriot,dubious,FAIL,110000000,113330342,215300000,328630342
2000,tt0138749,The Road to El Dorado,nowomen,FAIL,95000000,50802661,65700000,116502661
2000,tt0202677,The Way of the Gun,men,FAIL,9000000,6047856,13061935,19109791
2000,tt0190138,The Whole Nine Yards,ok,PASS,24000000,57262492,85527867,142790359
2000,tt0146309,Thirteen days,notalk,FAIL,80000000,34566746,66554547,101121293
2000,tt0120913,Titan A.E.,ok,PASS,75000000,22751979,36751979,59503958
2000,tt0217869,Unbreakable,nowomen,FAIL,73243106,94999143,248099143,343098286
2000,tt0182508,Urbania,notalk,FAIL,225000,1032075,1032075,2064150
2000,tt0190865,Vertical Limit,notalk,FAIL,75000000,68473360,213500000,281973360
2000,tt0161081,What Lies Beneath,ok,PASS,90000000,155464351,288693989,444158340
2000,tt0207201,What Women Want,notalk,FAIL,65000000,182805123,372100000,554905123
2000,tt0198021,Where the Heart Is,ok,PASS,15000000,33771174,40862054,74633228
2000,tt0190332,"Wo hu cang long (Crouching Tiger, Hidden Dragon)",ok,PASS,15000000,128067808,213200000,341267808
2000,tt0120903,X-Men,notalk,FAIL,75000000,157299717,296339717,453639434
1999,tt0147800,10 Things I Hate About You,ok,PASS,13000000,38177966,60414025,98591991
1999,tt0134273,8MM,notalk,FAIL,40000000,36443442,96398826,132842268
1999,tt0169547,American Beauty,ok,PASS,15000000,130058047,356258047,486316094
1999,tt0163651,American Pie,men,FAIL,12000000,101800948,234723148,336524096
1999,tt0122933,Analyze This,notalk,FAIL,30000000,106885658,176885658,283771316
1999,tt0166485,Anna and the King,men,FAIL,75000000,39251128,39251128,78502256
1999,tt0149691,Anywhere But Here,dubious,FAIL,23000000,18653615,18653615,37307230
1999,tt0145660,Austin Powers: The Spy Who Shagged Me,notalk,FAIL,35000000,206040085,310332636,516372721
1999,tt0120601,Being John Malkovich,ok,PASS,13000000,22858926,32382381,55241307
1999,tt0165643,Black and White,ok,PASS,10000000,5241315,5241315,10482630
1999,tt0181316,Blue Streak,notalk,FAIL,36000000,68208190,117448157,185656347
1999,tt0171804,Boys Don&#39;t Cry,ok,PASS,2000000,11540607,20741000,32281607
1999,tt0179116,But I&#39;m a Cheerleader,ok,PASS,1200000,2205627,2629191,4834818
1999,tt0144814,Carrie 2: The Rage,ok,PASS,21000000,17760244,17760244,35520488
1999,tt0139134,Cruel Intentions,ok,PASS,11000000,38230075,75803716,114033791
1999,tt0144168,Dick,ok,PASS,13000000,6276869,6276869,12553738
1999,tt0120655,Dogma,dubious,FAIL,10000000,30651422,43948865,74600287
1999,tt0157503,Drop Dead Gorgeous,ok,PASS,10000000,10571408,10571408,21142816
1999,tt0126886,Election,ok,PASS,8500000,14943582,17202854,32146436
1999,tt0120663,Eyes Wide Shut,ok,PASS,65000000,55691208,86257553,141948761
1999,tt0137523,Fight Club,notalk,FAIL,65000000,37030102,100853753,137883855
1999,tt0155711,Flawless,notalk,FAIL,27000000,4485485,4485485,8970970
1999,tt0126916,For Love of the Game,men,FAIL,50000000,35188640,46112640,81301280
1999,tt0177789,Galaxy Quest,notalk,FAIL,45000000,71423726,90523726,161947452
1999,tt0172493,"Girl, Interrupted",ok,PASS,24000000,28871190,28871190,57742380
1999,tt0139239,Go!,ok,PASS,6500000,16875273,28383441,45258714
1999,tt0155776,Jawbreaker,ok,PASS,3000000,3076820,3076820,6153640
1999,tt0175880,Magnolia,notalk,FAIL,37000000,22450975,48446802,70897777
1999,tt0158811,Muppets From Space,ok,PASS,24000000,16304786,16304786,32609572
1999,tt0132347,Mystery Men,nowomen,FAIL,68000000,29762011,33462011,63224022
1999,tt0125439,Notting Hill,ok,PASS,42000000,116089678,363728226,479817904
1999,tt0151804,Office Space,notalk,FAIL,10000000,10827813,12827813,23655626
1999,tt0120784,Payback,notalk,FAIL,50000000,81526121,161626121,243152242
1999,tt0190641,Pocket Monsters: Mewtwo Strikes Back!,notalk,FAIL,30000000,85744662,163644662,249389324
1999,tt0129332,Ravenous,notalk,FAIL,12000000,2062406,2062406,4124812
1999,tt0162661,Sleepy Hollow,ok,PASS,70000000,101068340,207068340,308136680
1999,tt0158983,South Park: Bigger Longer &amp; Uncut,dubious,FAIL,21000000,52037603,52037603,104075206
1999,tt0120915,Star Wars: Episode I - The Phantom Menace,ok,PASS,115000000,474544677,1007044677,1481589354
1999,tt0164912,Stuart Little,notalk,FAIL,105000000,140015224,298800000,438815224
1999,tt0120855,Tarzan,men,FAIL,145000000,171091819,448191819,619283638
1999,tt0120657,The 13th Warrior,dubious,FAIL,125000000,32698899,61698899,94397798
1999,tt0185937,The Blair Witch Project,ok,PASS,600000,140539099,248300000,388839099
1999,tt0144117,The Boondock Saints,nowomen,FAIL,7000000,30471,411874,442345
1999,tt0120689,The Green Mile,notalk,FAIL,60000000,136801374,290701374,427502748
1999,tt0171363,The Haunting,ok,PASS,80000000,91188905,180188905,271377810
1999,tt0129167,The Iron Giant,nowomen,FAIL,50000000,23159305,31333917,54493222
1999,tt0133093,The Matrix,ok,PASS,65000000,171479930,460279930,631759860
1999,tt0120616,The Mummy,notalk,FAIL,80000000,155385488,416385488,571770976
1999,tt0167404,The Sixth Sense,dubious,FAIL,40000000,293506292,672806292,966312584
1999,tt0134119,The Talented Mr. Ripley,dubious,FAIL,40000000,81292135,128792135,210084270
1999,tt0144640,Three to Tango,notalk,FAIL,20000000,10570375,10570375,21140750
1999,tt0151568,Topsy-Turvy,ok,PASS,20000000,6201757,6201757,12403514
1999,tt0120363,Toy Story 2,notalk,FAIL,90000000,245852179,511358276,757210455
1999,tt0120458,Virus,dubious,FAIL,75000000,14010690,30626690,44637380
1999,tt0120891,Wild Wild West,men,FAIL,175000000,113805681,221229335,335035016
1999,tt0131646,Wing Commander,men,FAIL,30000000,11578022,11578022,23156044
1998,tt0120577,54,notalk,FAIL,13000000,16757163,16757163,33514326
1998,tt0120623,A Bug&#39;s Life,ok,PASS,45000000,162798565,363095319,525893884
1998,tt0120586,American History X,men,FAIL,10000000,6719864,6719864,13439728
1998,tt0120591,Armageddon,notalk,FAIL,140000000,201578182,554600000,756178182
1998,tt0120603,Beloved,ok,PASS,53000000,22852487,22852487,45704974
1998,tt0120611,Blade,notalk,FAIL,45000000,70141876,131237688,201379564
1998,tt0144120,Bride of Chucky,notalk,FAIL,25000000,32404188,50692188,83096376
1998,tt0118789,Buffalo &#39;66,notalk,FAIL,1500000,2380606,2380606,4761212
1998,tt0118929,Dark City,notalk,FAIL,27000000,14435076,27257061,41692137
1998,tt0120647,Deep Impact,ok,PASS,80000000,140464664,349464664,489929328
1998,tt0134619,Disturbing Behavior,notalk,FAIL,15000000,17507368,17507368,35014736
1998,tt0127536,Elizabeth,ok,PASS,25000000,30082699,82150642,112233341
1998,tt0120660,Enemy of the State,notalk,FAIL,85000000,111549836,250649836,362199672
1998,tt0120631,Ever After,ok,PASS,26000000,65705772,65705772,131411544
1998,tt0120669,Fear and Loathing in Las Vegas,notalk,FAIL,18500000,10680275,13711903,24392178
1998,tt0154420,Festen (The Celebration),dubious,FAIL,1300000,1647780,1647780,3295560
1998,tt0162973,Get Real,men,FAIL,2000000,1152411,1152411,2304822
1998,tt0120685,Godzilla,dubious,FAIL,125000000,136314294,376000000,512314294
1998,tt0120694,Halloween H20: 20 Years Later,ok,PASS,17000000,55041738,55041738,110083476
1998,tt0147612,Happiness,ok,PASS,3000000,2746453,5746453,8492906
1998,tt0119313,Hope Floats,ok,PASS,30000000,60110313,81529000,141639313
1998,tt0147004,Little Voice,ok,PASS,6000000,4595000,21787233,26382233
1998,tt0120735,"Lock, Stock and Two Smoking Barrels",notalk,FAIL,1350000,3897569,28356188,32253757
1998,tt0120738,Lost in Space,ok,PASS,80000000,69117629,136047317,205164946
1998,tt0120749,Mercury Rising,notalk,FAIL,60000000,32983332,32983332,65966664
1998,tt0120762,Mulan,dubious,FAIL,90000000,120620254,303500000,424120254
1998,tt0120780,Out of Sight,men,FAIL,48000000,37562568,77562568,115125136
1998,tt0138704,Pi,men,FAIL,68000,3221152,4678513,7899665
1998,tt0120791,Practical Magic,ok,PASS,60000000,46850558,68336997,115187555
1998,tt0119942,Primary Colors,ok,PASS,65000000,39017984,39017984,78035968
1998,tt0120800,Quest for Camelot,ok,PASS,40000000,22772500,38172500,60945000
1998,tt0128442,Rounders,notalk,FAIL,12000000,22921898,22921898,45843796
1998,tt0130827,Run Lola Run,notalk,FAIL,1750000,7267324,14533173,21800497
1998,tt0120812,Rush Hour,ok,PASS,35000000,141186864,245300000,386486864
1998,tt0128445,Rushmore,notalk,FAIL,10000000,17105219,19080435,36185654
1998,tt0120813,Safe Men,nowomen,FAIL,1000000,21210,21210,42420
1998,tt0120815,Saving Private Ryan,nowomen,FAIL,65000000,216335085,485035085,701370170
1998,tt0138097,Shakespeare in Love,ok,PASS,26000000,100317794,279500000,379817794
1998,tt0120828,Six Days Seven Nights,notalk,FAIL,80000000,74339294,164800000,239139294
1998,tt0120148,Sliding Doors,ok,PASS,6000000,11911200,58809149,70720349
1998,tt0120831,Slums of Beverly Hills,ok,PASS,5000000,5502773,5502773,11005546
1998,tt0122718,Small Soldiers,notalk,FAIL,40000000,55143823,71743823,126887646
1998,tt0120321,Smoke Signals,ok,PASS,2000000,6719300,7756617,14475917
1998,tt0120184,Sphere,notalk,FAIL,73000000,37068294,50168294,87236588
1998,tt0120844,Star Trek: Insurrection,ok,PASS,70000000,70187658,117800000,187987658
1998,tt0120686,Stepmom,ok,PASS,50000000,91137662,159745279,250882941
1998,tt0118661,The Avengers,ok,PASS,60000000,23385416,48585416,71970832
1998,tt0118715,The Big Lebowski,notalk,FAIL,15000000,17498804,46189568,63688372
1998,tt0133751,The Faculty,dubious,FAIL,15000000,40283321,40283321,80566642
1998,tt0120744,The Man in the Iron Mask,notalk,FAIL,35000000,56968169,56968169,113936338
1998,tt0120746,The Mask of Zorro,notalk,FAIL,65000000,93828745,233700000,327528745
1998,tt0120768,The Negotiator,notalk,FAIL,50000000,44705766,49105766,93811532
1998,tt0120794,The Prince of Egypt,notalk,FAIL,60000000,101413188,218600000,320013188
1998,tt0120108,The Proposition,men,FAIL,20000000,1903434,5313608,7217042
1998,tt0120863,The Thin Red Line,notalk,FAIL,52000000,36400491,36400491,72800982
1998,tt0120382,The Truman Show,notalk,FAIL,60000000,125618201,248400000,374018201
1998,tt0129387,There&#39;s Something About Mary,ok,PASS,22000000,176484651,360099999,536584650
1998,tt0146336,Urban Legend,ok,PASS,14000000,38116707,72571864,110688571
1998,tt0120877,Vampires (John Carpenter&#39;s),nowomen,FAIL,20000000,20268825,20268825,40537650
1998,tt0120879,Velvet Goldmine,men,FAIL,9000000,1053788,4861972,5915760
1998,tt0120890,Wild Things,men,FAIL,20000000,29795299,55576699,85371998
1998,tt0128853,You&#39;ve Got Mail,ok,PASS,65000000,115821495,250800000,366621495
1997,tt0120133,A Simple Wish,ok,PASS,28000000,8165213,8165213,16330426
1997,tt0118570,Air Bud,notalk,FAIL,3000000,24646936,27788649,52435585
1997,tt0118571,Air Force One,notalk,FAIL,85000000,172956409,315268353,488224762
1997,tt0118583,Alien: Resurrection,ok,PASS,60000000,47795018,160700000,208495018
1997,tt0118617,Anastasia,ok,PASS,53000000,58403409,139801410,198204819
1997,tt0119822,As Good as It Gets,ok,PASS,50000000,148478011,314111923,462589934
1997,tt0118655,Austin Powers: International Man of Mystery,men,FAIL,18000000,53883989,67683989,121567978
1997,tt0118688,Batman &amp; Robin,men,FAIL,125000000,107325195,238317814,345643009
1997,tt0118749,Boogie Nights,dubious,FAIL,15000000,26410771,43111725,69522496
1997,tt0118829,Cats Don&#39;t Dance,ok,PASS,32000000,3588602,3588602,7177204
1997,tt0118842,Chasing Amy,ok,PASS,250000,12006514,15155095,27161609
1997,tt0128996,Cinderella,ok,PASS,2900000,85000000,85000000,170000000
1997,tt0118866,Clockwatchers,ok,PASS,2000000,537948,539961,1077909
1997,tt0118880,Con Air,notalk,FAIL,80000000,101117573,224117573,325235146
1997,tt0118883,Conspiracy Theory,men,FAIL,80000000,76118990,142783718,218902708
1997,tt0118884,Contact,ok,PASS,90000000,100920329,165900000,266820329
1997,tt0119080,Eve&#39;s Bayou,ok,PASS,5000000,14843425,14843425,29686850
1997,tt0119081,Event Horizon,ok,PASS,60000000,26673242,26673242,53346484
1997,tt0119114,Fever Pitch,ok,PASS,40000000,42071069,50071069,92142138
1997,tt0119137,Flubber,men,FAIL,80000000,92993801,177993801,270987602
1997,tt0119173,G.I. Jane,ok,PASS,50000000,48169156,48169156,96338312
1997,tt0119177,Gattaca,notalk,FAIL,36000000,12532777,12532777,25065554
1997,tt0119190,George of the Jungle,ok,PASS,55000000,105263257,174463257,279726514
1997,tt0119217,Good Will Hunting,nowomen,FAIL,10000000,138433435,225933435,364366870
1997,tt0119229,Grosse Pointe Blank,ok,PASS,15000000,28084357,31070412,59154769
1997,tt0119282,Hercules,ok,PASS,70000000,99112101,250700000,349812101
1997,tt0119345,I Know What You Did Last Summer,ok,PASS,17000000,72250091,125250091,197500182
1997,tt0119361,In the Company of Men,notalk,FAIL,25000,2883661,2883661,5767322
1997,tt0119396,Jackie Brown,ok,PASS,12000000,39673162,74727492,114400654
1997,tt0119468,Kiss the Girls,men,FAIL,27000000,60527873,60527873,121055746
1997,tt0119488,L.A. Confidential,notalk,FAIL,35000000,64604977,110604977,175209954
1997,tt0119528,Liar Liar,notalk,FAIL,45000000,181410615,302710615,484121230
1997,tt0119654,Men in Black,notalk,FAIL,90000000,250690539,587790539,838481078
1997,tt0119698,Mononoke-hime,ok,PASS,20000000,2374107,150350000,152724107
1997,tt0119707,Mortal Kombat: Annihilation,ok,PASS,30000000,35927406,51327406,87254812
1997,tt0417001,Must love Dogs,men,FAIL,35000000,43894863,58894863,102789726
1997,tt0119738,My Best Friend&#39;s Wedding,men,FAIL,46000000,126813153,298923419,425736572
1997,tt0124819,Orgazmo,notalk,FAIL,1000000,582024,627287,1209311
1997,tt0120082,Scream 2,ok,PASS,24000000,101363301,101363301,202726602
1997,tt0120094,Selena,ok,PASS,20000000,35450113,35450113,70900226
1997,tt0120152,Smilla&#39;s Sense of Snow,ok,PASS,35000000,2221994,2221994,4443988
1997,tt0120177,Spawn,ok,PASS,40000000,54979992,87949859,142929851
1997,tt0120201,Starship Troopers,ok,PASS,100000000,54768952,121100000,175868952
1997,tt0118971,The Devil&#39;s Advocate,ok,PASS,57000000,61007424,153007424,214014848
1997,tt0119116,The Fifth Element,notalk,FAIL,95000000,63570862,263900000,327470862
1997,tt0119174,The Game,notalk,FAIL,50000000,48265581,48265581,96531162
1997,tt0119567,The Lost World: Jurassic Park,dubious,FAIL,75000000,229086679,786686679,1015773358
1997,tt0119874,The Peacemaker,dubious,FAIL,50000000,41263140,62967368,104230508
1997,tt0119925,The Postman,notalk,FAIL,80000000,17650704,17650704,35301408
1997,tt0120338,Titanic,ok,PASS,200000000,658672302,2185672302,2844344604
1997,tt0120461,Volcano,ok,PASS,90000000,47546796,120100000,167646796
1996,tt0115591,August,dubious,FAIL,3400000,12636,12636,25272
1996,tt0115736,Bound,ok,PASS,4500000,3802260,7011317,10813577
1996,tt0115759,Broken Arrow,nowomen,FAIL,65000000,70645997,148345997,218991994
1996,tt0115857,Chain Reaction,notalk,FAIL,55000000,21226204,60209334,81435538
1996,tt0116136,DragonHeart,men,FAIL,57000000,51364680,104364680,155729360
1996,tt0116191,Emma,ok,PASS,5900000,22231658,37831658,60063316
1996,tt0116225,Escape from L.A.,notalk,FAIL,50000000,25426861,25426861,50853722
1996,tt0116260,Eye for an Eye,ok,PASS,20000000,26792700,26792700,53585400
1996,tt0116282,Fargo,ok,PASS,7000000,24567751,51204567,75772318
1996,tt0116361,Freeway,ok,PASS,3000000,295493,295493,590986
1996,tt0116367,From Dusk Till Dawn,notalk,FAIL,20000000,25728961,25728961,51457922
1996,tt0116477,Hamlet,notalk,FAIL,2000000,1577287,2419669,3996956
1996,tt0116493,Harriet the Spy,ok,PASS,13000000,26570048,26570048,53140096
1996,tt0116629,Independence Day,ok,PASS,75000000,306169255,817400878,1123570133
1996,tt0116705,Jingle All the Way,notalk,FAIL,60000000,60592389,129832389,190424778
1996,tt0116778,Kingpin,notalk,FAIL,25000000,25023424,32223424,57246848
1996,tt0116931,Love and Other Catastrophes,ok,PASS,250000,212285,743216,955501
1996,tt0116996,Mars Attacks!,ok,PASS,80000000,37771017,101371017,139142034
1996,tt0117060,Mission: Impossible,notalk,FAIL,80000000,180981886,457697994,638679880
1996,tt0117509,Romeo + Juliet,dubious,FAIL,14500000,46338728,147542381,193881109
1996,tt0117571,Scream,ok,PASS,15000000,103046663,173046663,276093326
1996,tt0117589,Secrets &amp; Lies,ok,PASS,4500000,13417292,13417292,26834584
1996,tt0117603,Set It Off,ok,PASS,9000000,36049108,36049108,72098216
1996,tt0117705,Space Jam,notalk,FAIL,80000000,90463534,250200000,340663534
1996,tt0117723,Spy Hard,notalk,FAIL,18000000,26936265,26936265,53872530
1996,tt0117731,Star Trek: First Contact,ok,PASS,46000000,92027888,150000000,242027888
1996,tt0117765,Striptease,dubious,FAIL,50000000,33109743,113309743,146419486
1996,tt0117887,That Thing You Do!,ok,PASS,2500000,25857416,34557416,60414832
1996,tt0115798,The Cable Guy,notalk,FAIL,47000000,60240295,102825796,163066091
1996,tt0115963,The Craft,ok,PASS,15000000,24769466,55669466,80438932
1996,tt0116209,The English Patient,ok,PASS,35000000,78716374,231716374,310432748
1996,tt0116277,The Fan,notalk,FAIL,55000000,18582965,18582965,37165930
1996,tt0116313,The First Wives Club,ok,PASS,30000000,105489203,181489203,286978406
1996,tt0116421,The Glimmer Man,notalk,FAIL,45000000,20404841,36404841,56809682
1996,tt0116583,The Hunchback of Notre Dame,notalk,FAIL,100000000,100138851,325500000,425638851
1996,tt0116908,The Long Kiss Goodnight,notalk,FAIL,65000000,33447612,33447612,66895224
1996,tt0117057,The Mirror Has Two Faces,ok,PASS,42000000,41267469,41267469,82534938
1996,tt0117500,The Rock,notalk,FAIL,75000000,134069511,336069511,470139022
1996,tt0117951,Trainspotting,men,FAIL,3100000,16501785,24000785,40502570
1996,tt0117998,Twister,ok,PASS,88000000,241888385,495900000,737788385
1996,tt0118113,Walking and Talking,ok,PASS,1000000,1287480,1615787,2903267
1996,tt0115856,When the Cat&#39;s Away,ok,PASS,300000,1652472,2525984,4178456
1995,tt0112384,Apollo 13,ok,PASS,65000000,172070496,334100000,506170496
1995,tt0112401,Assassins,notalk,FAIL,50000000,30306268,83306268,113612536
1995,tt0112462,Batman Forever,notalk,FAIL,100000000,184031112,336529144,520560256
1995,tt0112471,Before Sunrise,nowomen,FAIL,2500000,5274005,5274005,10548010
1995,tt0112573,Braveheart,men,FAIL,72000000,75545647,209000000,284545647
1995,tt0112641,Casino,men,FAIL,52000000,42438300,110400000,152838300
1995,tt0112642,Casper,ok,PASS,55000000,100328194,282300000,382628194
1995,tt0112697,Clueless,ok,PASS,13700000,56598476,56598476,113196952
1995,tt0112715,Congo,nowomen,FAIL,50000000,81022333,152022333,233044666
1995,tt0112722,Copycat,dubious,FAIL,20000000,32051917,32051917,64103834
1995,tt0112864,Die Hard: With a Vengeance,notalk,FAIL,90000000,100012499,364480746,464493245
1995,tt0113101,Four rooms,notalk,FAIL,4000000,4301000,4301000,8602000
1995,tt0113321,Home for the holidays,ok,PASS,20000000,17468887,22119269,39588156
1995,tt0113497,Jumanji,ok,PASS,65000000,100458310,262758310,363216620
1995,tt0113749,Mallrats,notalk,FAIL,6100000,2108367,2108367,4216734
1995,tt0113855,Mortal Kombat,notalk,FAIL,20000000,70433227,122133227,192566454
1995,tt0114069,Outbreak,ok,PASS,50000000,67823573,67823573,135647146
1995,tt0114148,Pocahontas,ok,PASS,55000000,141579773,347100000,488679773
1995,tt0112130,Pride and Prejudice,ok,PASS,28000000,38372662,120918508,159291170
1995,tt0114319,Sabrina,ok,PASS,58000000,53458319,87100000,140558319
1995,tt0114323,Safe,ok,PASS,33000000,17142080,41495213,58637293
1995,tt0114369,Se7en,notalk,FAIL,30000000,100125643,328125643,428251286
1995,tt0114388,Sense and Sensibility,ok,PASS,16500000,42993774,134993774,177987548
1995,tt0114436,Showgirls,ok,PASS,40000000,20350754,37750754,58101508
1995,tt0114508,Species,dubious,FAIL,35000000,60054449,113354449,173408898
1995,tt0114614,Tank Girl,ok,PASS,25000000,4064333,4064333,8128666
1995,tt0112346,The American President,ok,PASS,62000000,60022813,107822813,167845626
1995,tt0112579,The Bridges of Madison County,ok,PASS,22000000,71516617,175516617,247033234
1995,tt0113416,The Incredibly True Adventures of Two Girls in Love,ok,PASS,250000,2210408,2477155,4687563
1995,tt0113957,The Net,ok,PASS,22000000,50621733,110521733,161143466
1995,tt0114214,The Quick and the Dead,notalk,FAIL,32000000,18552460,18552460,37104920
1995,tt0114814,The Usual Suspects,notalk,FAIL,6000000,23341568,34449356,57790924
1995,tt0114709,Toy Story,notalk,FAIL,30000000,191780865,364530148,556311013
1995,tt0114746,Twelve Monkeys,notalk,FAIL,29000000,57141459,168841459,225982918
1995,tt0114898,Waterworld,nowomen,FAIL,175000000,88246220,264246220,352492440
1995,tt0114906,Welcome to the Dollhouse,ok,PASS,800000,4198137,5034794,9232931
1994,tt0109040,Ace Ventura: Pet Detective,men,FAIL,12000000,72217396,107217396,179434792
1994,tt0109254,Beverly Hills Cop III,nowomen,FAIL,50000000,42586861,119180938,161767799
1994,tt0109445,Clerks.,notalk,FAIL,27000,3073428,3894240,6967668
1994,tt0109504,Crooklyn,ok,PASS,14000000,13024170,13024170,26048340
1994,tt0109686,Dumb &amp; Dumber,men,FAIL,16000000,127175374,246400000,373575374
1994,tt0109707,Ed Wood,ok,PASS,18000000,5828466,5828466,11656932
1994,tt0109830,Forrest Gump,notalk,FAIL,55000000,329694499,679400525,1009095024
1994,tt0110322,Legends of the Fall,ok,PASS,30000000,66502573,160502573,227005146
1994,tt0110367,Little Women,ok,PASS,15000000,50003303,50003303,100006606
1994,tt0110622,Naked Gun 33 1/3: The Final Insult,men,FAIL,30000000,51041856,51041856,102083712
1994,tt0110857,Police Academy: Mission to Moscow,notalk,FAIL,10000000,126247,126247,252494
1994,tt0110889,Priest,ok,PASS,60000000,29136626,84154026,113290652
1994,tt0110912,Pulp Fiction,ok,PASS,8000000,107928762,212928762,320857524
1994,tt0111257,Speed,ok,PASS,30000000,121248145,283200000,404448145
1994,tt0111282,Stargate,notalk,FAIL,55000000,71565669,196565669,268131338
1994,tt0111301,Street Fighter,ok,PASS,35000000,33423000,99423000,132846000
1994,tt0109446,The Client,ok,PASS,45000000,92115211,117615211,209730422
1994,tt0110074,The Hudsucker Proxy,notalk,FAIL,40000000,2816518,14938149,17754667
1994,tt0110357,The Lion King,notalk,FAIL,79300000,422780140,952880140,1375660280
1994,tt0110475,The Mask,notalk,FAIL,18000000,119920129,351620129,471540258
1994,tt0111070,The Santa Clause,notalk,FAIL,22000000,144833357,189800000,334633357
1994,tt0111143,The Shadow,nowomen,FAIL,40000000,31835600,31835600,63671200
1994,tt0111161,The Shawshank Redemption,nowomen,FAIL,25000000,28241469,28241469,56482938
1994,tt0111255,The Specialist,notalk,FAIL,45000000,57362581,57362581,114725162
1994,tt0111438,Timecop,notalk,FAIL,28000000,44853581,102053581,146907162
1994,tt0111503,True Lies,notalk,FAIL,100000000,146282411,365300000,511582411
1993,tt0106582,Cliffhanger,notalk,FAIL,65000000,84049211,255000000,339049211
1993,tt0106611,Cool Runnings,notalk,FAIL,14000000,68856263,155056263,223912526
1993,tt0106677,Dazed and Confused,ok,PASS,6900000,7950889,7950889,15901778
1993,tt0107007,Gettysburg,nowomen,FAIL,25000000,10731997,10731997,21463994
1993,tt0107048,Groundhog Day,men,FAIL,14600000,70906973,70906973,141813946
1993,tt0107120,Hocus Pocus,ok,PASS,28000000,39360491,39360491,78720982
1993,tt0107290,Jurassic Park,ok,PASS,63000000,395708305,1035626872,1431335177
1993,tt0107614,Mrs. Doubtfire,ok,PASS,25000000,219195051,441286003,660481054
1993,tt0311648,Pieces of April,ok,PASS,300000,2528664,3590570,6119234
1993,tt0108052,Schindler&#39;s List,ok,PASS,25000000,96067179,321365567,417432746
1993,tt0108255,Super Mario Bros.,dubious,FAIL,42000000,20844907,20844907,41689814
1993,tt0106226,The Age of Innocence,ok,PASS,34000000,32014993,32014993,64029986
1993,tt0106977,The Fugitive,men,FAIL,44000000,183875760,353715317,537591077
1993,tt0112389,The Princess and the Cobbler,nowomen,FAIL,24000000,669276,669276,1338552
1993,tt0107943,The Remains of the Day,nowomen,FAIL,15000000,22954968,63954968,86909936
1993,tt0108358,Tombstone,ok,PASS,25000000,56505065,56505065,113010130
1992,tt0104257,A Few Good Men,notalk,FAIL,33000000,141340178,236500000,377840178
1992,tt0104694,A League of Their Own,ok,PASS,40000000,107533925,132440066,239973991
1992,tt0103639,Aladdin,nowomen,FAIL,28000000,217350219,504050219,721400438
1992,tt0103644,Alien 3,nowomen,FAIL,55000000,54927174,158500000,213427174
1992,tt0106308,Army of Darkness,men,FAIL,11000000,11502976,21502976,33005952
1992,tt0103776,Batman Returns,nowomen,FAIL,80000000,162833635,266824291,429657926
1992,tt0103893,Buffy the Vampire Slayer,ok,PASS,7000000,14231669,14231669,28463338
1992,tt0104070,Death Becomes Her,ok,PASS,55000000,58422650,149022650,207445300
1992,tt0104815,El Mariachi,nowomen,FAIL,7000,2040920,2041928,4082848
1992,tt0104348,Glengarry Glen Ross,nowomen,FAIL,12500000,10725228,10725228,21450456
1992,tt0104412,Hero,notalk,FAIL,42000000,19487173,66787173,86274346
1992,tt0104431,Home Alone 2: Lost in New York,notalk,FAIL,20000000,173585516,358994850,532580366
1992,tt0104797,Malcolm X,dubious,FAIL,35000000,48169910,48169910,96339820
1992,tt0104952,My Cousin Vinny,notalk,FAIL,11000000,52929168,52929168,105858336
1992,tt0105236,Reservoir Dogs,nowomen,FAIL,1200000,2832029,2832029,5664058
1992,tt0104036,The Crying Game,men,FAIL,4000000,62546695,62546695,125093390
1992,tt0104868,The Mighty Ducks,notalk,FAIL,10000000,50752337,50752337,101504674
1992,tt0104940,The Muppet Christmas Carol,notalk,FAIL,12000000,27281507,27281507,54563014
1992,tt0105151,The Player,ok,PASS,8000000,21706101,28876702,50582803
1992,tt0105793,Wayne&#39;s World,notalk,FAIL,20000000,121697323,183097323,304794646
1991,tt0101414,Beauty and the Beast,ok,PASS,20000000,218951625,451421625,670373250
1991,tt0101452,Bill &amp; Ted&#39;s Bogus Journey,notalk,FAIL,20000000,37537675,37537675,75075350
1991,tt0102057,Hook,men,FAIL,70000000,119654823,300854823,420509646
1991,tt0102070,Hudson Hawk,ok,PASS,65000000,17218916,17218916,34437832
1991,tt0102798,Robin Hood: Prince of Thieves,dubious,FAIL,50000000,165493908,390500000,555993908
1991,tt0102943,Slacker,ok,PASS,23000,1227508,1227508,2455016
1991,tt0102975,Star Trek VI: The Undiscovered Country,men,FAIL,27000000,74888996,96900000,171788996
1991,tt0103060,Teenage Mutant Ninja Turtles II: The Secret of the Ooze,ok,PASS,25000000,78656813,78656813,157313626
1991,tt0103064,Terminator 2: Judgement Day,dubious,FAIL,100000000,204859496,516816151,721675647
1991,tt0101272,The Addams Family,ok,PASS,30000000,113502246,191502246,305004492
1991,tt0102510,The Naked Gun 2 1/2: The Smell of Fear,notalk,FAIL,23000000,86930411,86930411,173860822
1991,tt0102926,The Silence of the Lambs,ok,PASS,20000000,130726716,275726716,406453432
1991,tt0103247,White Fang,notalk,FAIL,14000000,34729091,34729091,69458182
1990,tt0099088,Back to the Future Part III,notalk,FAIL,40000000,87666629,243700000,331366629
1990,tt0099253,Child&#39;s Play 2,ok,PASS,13000000,26904572,34166572,61071144
1990,tt0099817,Dark Angel (I Come in Peace),nowomen,FAIL,7000000,4372561,4372561,8745122
1990,tt0099423,Die Hard 2,dubious,FAIL,70000000,117323878,239814025,357137903
1990,tt0099487,Edward Scissorhands,ok,PASS,20000000,53976987,53976987,107953974
1990,tt0099582,Flatliners,ok,PASS,26000000,61308153,61308153,122616306
1990,tt0099653,Ghost,men,FAIL,22000000,217631306,517600000,735231306
1990,tt0099685,Goodfellas,men,FAIL,25000000,46743809,46743809,93487618
1990,tt0099785,Home Alone,men,FAIL,15000000,285761243,476684675,762445918
1990,tt0100263,Nikita,ok,PASS,7000000,5017971,5017971,10035942
1990,tt0100403,Predator 2,men,FAIL,35000000,28317513,54768418,83085931
1990,tt0100405,Pretty Woman,ok,PASS,14000000,178406268,432645872,611052140
1990,tt0099810,The Hunt for Red October,notalk,FAIL,30000000,120709866,200500000,321209866
1990,tt0100802,Total Recall,notalk,FAIL,125000000,58877969,198615996,257493965
1990,tt0100814,Tremors,ok,PASS,10000000,16667084,16667084,33334168
1989,tt0096874,Back to the Future Part II,ok,PASS,40000000,118450002,332000000,450450002
1989,tt0096895,Batman,notalk,FAIL,35000000,251188924,411348924,662537848
1989,tt0096928,Bill &amp; Ted&#39;s Excellent Adventure,men,FAIL,10000000,40485039,40485039,80970078
1989,tt0097165,Dead Poets Society,notalk,FAIL,16400000,95860116,239500000,335360116
1989,tt0097499,Henry V,ok,PASS,9000000,10161099,10161099,20322198
1989,tt0097576,Indiana Jones and the Last Crusade,nowomen,FAIL,48000000,197171806,474171806,671343612
1989,tt0097742,Licence to Kill,men,FAIL,42000000,34667015,156167015,190834030
1989,tt0097815,Major League,notalk,FAIL,11000000,49793054,49793054,99586108
1989,tt0098206,Road House,notalk,FAIL,10000000,30050028,30050028,60100056
1989,tt0098724,"Sex, Lies, and Videotape",men,FAIL,1200000,24741667,36741667,61483334
1989,tt0098382,Star Trek V: The Final Frontier,notalk,FAIL,30000000,52210049,70200000,122410049
1989,tt0096754,The Abyss,ok,PASS,70000000,54243125,54243125,108486250
1989,tt0098519,Troop Beverly Hills,ok,PASS,18000000,7190505,7190505,14381010
1989,tt0098546,UHF,notalk,FAIL,5000000,6157157,6157157,12314314
1988,tt0094612,Action Jackson,notalk,FAIL,7000000,20257000,20257000,40514000
1988,tt0094625,Akira,notalk,FAIL,8000000,19585,19585,39170
1988,tt0094721,Beetle Juice,ok,PASS,15000000,73326666,73326666,146653332
1988,tt0092675,Bloodsport,notalk,FAIL,1500000,11806119,11806119,23612238
1988,tt0094862,Child&#39;s Play,ok,PASS,9000000,33244684,44196684,77441368
1988,tt0094947,Dangerous Liaisons,ok,PASS,14000000,34700000,34700000,69400000
1988,tt0095016,Die Hard,ok,PASS,28000000,81350242,139109346,220459588
1988,tt0095631,Midnight Run,men,FAIL,30000000,38413606,81613606,120027212
1988,tt0095687,My Stepmother Is an Alien,ok,PASS,16000000,13854000,13854000,27708000
1988,tt0095690,Mystic Pizza,ok,PASS,6000000,12793213,12793213,25586426
1988,tt0095889,Poltergeist III,ok,PASS,9500000,14114000,14114000,28228000
1988,tt0095953,Rain Man,notalk,FAIL,25000000,172825435,412800000,585625435
1988,tt0096061,Scrooged,ok,PASS,32000000,60328558,60328558,120657116
1988,tt0095489,The Land Before Time,ok,PASS,12300000,48092846,81972846,130065692
1988,tt0095497,The Last Temptation of Christ,men,FAIL,7000000,8373585,8373585,16747170
1988,tt0096256,They Live,nowomen,FAIL,4000000,13000000,13000000,26000000
1988,tt0096320,Twins,men,FAIL,15000000,111936388,216600000,328536388
1988,tt0096438,Who Framed Roger Rabbit,notalk,FAIL,70000000,154112492,351500000,505612492
1988,tt0096487,Young Guns,notalk,FAIL,13000000,44726644,44726644,89453288
1987,tt0092644,Beverly Hills Cop II,notalk,FAIL,20000000,153665036,276665036,430330072
1987,tt0092991,Evil Dead II,dubious,FAIL,3500000,5923044,5923044,11846088
1987,tt0093010,Fatal Attraction,dubious,FAIL,14000000,156645693,320100000,476745693
1987,tt0093105,"Good Morning, Vietnam",notalk,FAIL,13000000,123922370,123922370,247844740
1987,tt0093177,Hellraiser,ok,PASS,1000000,14564000,14564000,29128000
1987,tt0093409,Lethal Weapon,notalk,FAIL,15000000,65192350,120192350,185384700
1987,tt0093773,Predator,nowomen,FAIL,18000000,59735548,98267558,158003106
1987,tt0093818,Radio Days,notalk,FAIL,16000000,14792779,14792779,29585558
1987,tt0093870,RoboCop,notalk,FAIL,120000000,54764805,221577330,276342135
1987,tt0094012,Spaceballs,dubious,FAIL,22700000,38119483,38119483,76238966
1987,tt0094074,Superman IV: The Quest for Peace,ok,PASS,17000000,11227824,11227824,22455648
1987,tt0093389,The Last Emperor,dubious,FAIL,25000000,43984000,43984000,87968000
1987,tt0093437,The Lost Boys,notalk,FAIL,8500000,32222567,32222567,64445134
1987,tt0093779,The Princess Bride,men,FAIL,15000000,30857000,30857000,61714000
1986,tt0090605,Aliens,ok,PASS,17000000,85160248,183316455,268476703
1986,tt0090555,Crocodile Dundee,dubious,FAIL,5000000,174803506,328000000,502803506
1986,tt0091203,Highlander,ok,PASS,16000000,5900000,12900000,18800000
1986,tt0091225,Howard The Duck,dubious,FAIL,30000000,16295774,16295774,32591548
1986,tt0091419,Little Shop of Horrors,notalk,FAIL,30000000,38747385,38747385,77494770
1986,tt0091738,Peggy Sue Got Married,ok,PASS,18000000,41382841,41382841,82765682
1986,tt0091763,Platoon,nowomen,FAIL,6000000,137963328,137963328,275926656
1986,tt0092005,Stand By Me,nowomen,FAIL,8000000,52287414,52287414,104574828
1986,tt0090848,The Clan of the Cave Bear,ok,PASS,15000000,1953732,1953732,3907464
1986,tt0092099,Top Gun,men,FAIL,15000000,179800601,356800601,536601202
1985,tt0088763,Back to the Future,notalk,FAIL,19000000,210609762,383874862,594484624
1985,tt0088846,Brazil,ok,PASS,15000000,9929135,9929135,19858270
1985,tt0088944,Commando,notalk,FAIL,10000000,35073978,35073978,70147956
1985,tt0088993,Day of the Dead,nowomen,FAIL,18000000,N/A,N/A,#VALUE!
1985,tt0089457,Ladyhawke,nowomen,FAIL,20000000,18400000,18400000,36800000
1985,tt0089469,Legend,dubious,FAIL,25000000,15502112,15502112,31004224
1985,tt0091578,My Beautiful Laundrette,men,FAIL,400000,N/A,N/A,#VALUE!
1985,tt0089893,Red Sonja,ok,PASS,17900000,6905861,6905861,13811722
1985,tt0089908,Return to Oz,ok,PASS,27000000,10618813,10618813,21237626
1985,tt0088939,The Color Purple,ok,PASS,15000000,93589701,93589701,187179402
1984,tt0087800,A nightmare on Elm Street,men,FAIL,35000000,63075011,117729621,180804632
1984,tt0086879,Amadeus,ok,PASS,18000000,51973029,51973029,103946058
1984,tt0086960,Beverly Hills Cop,nowomen,FAIL,15000000,234760478,316300000,551060478
1984,tt0086984,Body Double,men,FAIL,10000000,8801940,8801940,17603880
1984,tt0087078,Conan the Destroyer,dubious,FAIL,18000000,26400000,26400000,52800000
1984,tt0087182,Dune,dubious,FAIL,45000000,27447471,27447471,54894942
1984,tt0087298,Friday the 13th Part IV: The Final Chapter,ok,PASS,2600000,32980880,32980880,65961760
1984,tt0087332,Ghostbusters,notalk,FAIL,30000000,238632124,291632124,530264248
1984,tt0087363,Gremlins,notalk,FAIL,11000000,148168459,148168459,296336918
1984,tt0087469,Indiana Jones and the Temple of Doom,nowomen,FAIL,28000000,179880271,333080271,512960542
1984,tt0087928,Police Academy,dubious,FAIL,4500000,81198894,81198894,162397788
1984,tt0087995,Repo Man,men,FAIL,1500000,2300000,2300000,4600000
1984,tt0088161,Splash,notalk,FAIL,8000000,62599495,62599495,125198990
1984,tt0088170,Star Trek III: The Search for Spock,notalk,FAIL,18000000,76471046,87000000,163471046
1984,tt0087538,The Karate Kid,ok,PASS,40000000,176591618,359091618,535683236
1984,tt0088247,The Terminator,men,FAIL,6400000,38019031,78019031,116038062
1983,tt0085549,Flashdance,ok,PASS,7000000,90463574,201463574,291927148
1983,tt0086190,Star Wars: Episode VI - Return of the Jedi,nowomen,FAIL,32500000,309205079,572700000,881905079
1983,tt0086393,Superman III,ok,PASS,39000000,59950623,59950623,119901246
1983,tt0086541,Videodrome,men,FAIL,5952000,2120439,2120439,4240878
1983,tt0086567,WarGames,notalk,FAIL,12000000,74433837,74433837,148867674
1982,tt0083658,Blade Runner,notalk,FAIL,28000000,32656328,33139618,65795946
1982,tt0083722,Cat People,ok,PASS,12500000,7000000,21000000,28000000
1982,tt0082198,Conan the Barbarian,notalk,FAIL,20000000,38264085,79114085,117378170
1982,tt0083833,Diner,notalk,FAIL,5000000,12592907,12592907,25185814
1982,tt0083866,E.T.: The Extra-Terrestrial,dubious,FAIL,10500000,435110554,792965326,1228075880
1982,tt0083929,Fast Times at Ridgemont High,men,FAIL,4500000,27092880,27092880,54185760
1982,tt0083944,First Blood,nowomen,FAIL,14000000,47212904,125212904,172425808
1982,tt0083972,Friday the 13th Part III,dubious,FAIL,2250000,36690067,36690067,73380134
1982,tt0084516,Poltergeist,ok,PASS,10700000,74706019,121706019,196412038
1982,tt0084522,Porky&#39;s,men,FAIL,4000000,109492484,109492484,218984968
1982,tt0084726,Star Trek: The Wrath of Khan,dubious,FAIL,12000000,79912963,96800000,176712963
1982,tt0083642,The Best Little Whorehouse in Texas,ok,PASS,20500000,69701637,69701637,139403274
1982,tt0084805,Tootsie,notalk,FAIL,15000000,177200000,177200000,354400000
1982,tt0084827,TRON,nowomen,FAIL,17000000,26918576,26918576,53837152
1981,tt0082096,Das Boot,nowomen,FAIL,12000000,11487676,84970337,96458013
1981,tt0082340,Escape from New York,nowomen,FAIL,6000000,25244700,25244700,50489400
1981,tt0082418,Friday the 13th Part 2,notalk,FAIL,1250000,21722776,21722776,43445552
1981,tt0082495,Halloween II,ok,PASS,2500000,25533818,25533818,51067636
1981,tt0082509,Heavy Metal,notalk,FAIL,9300000,19571091,19571091,39142182
1981,tt0082517,History of the World: Part I,notalk,FAIL,11000000,31672000,31672000,63344000
1981,tt0082971,Raiders of the Lost Ark,nowomen,FAIL,20000000,248159971,389925971,638085942
1981,tt0083907,The Evil Dead,notalk,FAIL,375000,2400000,29400000,31800000
1981,tt0081633,Time Bandits,notalk,FAIL,12000000,37400000,37400000,74800000
1980,tt0080339,Airplane!,dubious,FAIL,3500000,83453539,83453539,166907078
1980,tt0080492,Can&#39;t Stop the Music,ok,PASS,20000000,2000000,2000000,4000000
1980,tt0080716,Fame,ok,PASS,18000000,22455510,77956957,100412467
1980,tt0080745,Flash Gordon,dubious,FAIL,35000000,27107960,27107960,54215920
1980,tt0080761,Friday the 13th,men,FAIL,17000000,65002019,91700771,156702790
1980,tt0080855,Heaven&#39;s Gate,nowomen,FAIL,44000000,3484331,3484331,6968662
1980,tt0081375,Private Benjamin,ok,PASS,15000000,69847348,69847348,139694696
1980,tt0081398,Raging Bull,notalk,FAIL,18000000,23380203,23380203,46760406
1980,tt0081534,Somewhere in Time,men,FAIL,5100000,9709597,9709597,19419194
1980,tt0080684,Star Wars: Episode V - The Empire Strikes Back,nowomen,FAIL,23000000,290271960,534171960,824443920
1980,tt0081573,Superman II,dubious,FAIL,54000000,108185706,108185706,216371412
1980,tt0080455,The Blues Brothers,notalk,FAIL,27000000,57229890,57229890,114459780
1980,tt0080749,The Fog,ok,PASS,18000000,29511112,37048526,66559638
1980,tt0081505,The Shining,men,FAIL,19000000,44017374,44017374,88034748
